(155, 118)
(5, 101)
(159, 62)
(140, 24)
(77, 63)
(30, 44)
(136, 33)
(17, 37)
(70, 48)
(140, 0)
1111101111111100011110011101001110111011101111111110110110111010111011011111111a1111111101011111111110101111111001011011100110121211212b2221011202211201010a1111
1110111011111110111111111110111011111111011011111100110101111110100111101111110a1111011111011111111011011111110111101010011112111021220a1210210211110112210a1100
0111101111111110100110111111111110110101111111111111111111110011111111111111111a1110101011101010111111011111111111111111111111012212022a1211212221201102201a1111
1101110111011111111001111010111111011011011101101111111101110111010110110111111a1110101110101000110111101011111111110101111112111212001a2222002221221121121a1111
1111111111101101110111001011011110111111101111111111110011011110111100110111111a1111111111110011111011101111100110011111011111020122011a2101112112112101101a1101
0111111111111111011111111001110111110111110111100101111011111110111111001011111a1101011111111111011110111111110111011111111112200222110b2110011222120222121a1111
1111111101110111111111011111110011011111111111111011101010111111111111101001111a0111111111011110011011101111111001010111111112121222121a0221211212222020120a1011
0111011111111011101111011111111011111011000111011101101111101111111010101111111a1111110111111011111111111111100111110111101012120212012b1110012121020121120a1101
1110011111111010111101111101111111010011101110011011111100111010101110111111111a1110111111111111011110111110010111100111111111221222211b2222211222210012220a1111
1111101111111111111111101101110110111111111111100111110100110101010111101110110a1111101111111101101111111111101111101001111012010222212b0021202222202120201a1101
1111111111011110110101111001101001111101111111111110010111111111010101111111110a1111100110111110011011011111110011110010011112222102220b1222221212121222201a1111
0111111111011011111111111111101111111111111111110000101011111110111111111111011a1100011111111111111001011101011111111111110010211012222b2022202120000120111a1111
1111111111111101101110111111110000111111010011100101101111111111110011111001000a1110110010111000111111111101101111111101111111022222211b2202020212102222220a1101
1111111110111111111001101111111011101110100010111101111111111101111110111111011a1010110011110110111111111110111101011110110012211021220b2020022212212222220a1010
0010111110100111111011101111011110111111111111111111101111110111111011111100011a1111101111110101111111111111111111110110111112202202202b0220222020212010220a0111
1000101011111110110111111111111111111111101111111101101001111111101111100111110a0101111101101111011100111111010110110100111112120110121b1121200210221201201a0111
1011111110111101101111111110101111111111101111111101111101111110111111111011111a1101111111111111111111111010101111111111111112202201202a0212221102121022222a1110
1110111111101011111001111111101011111111111111100111111110011111110001110110111a1111101011111111111111100110110110110011101111220201002a1112101211111110212a1111
1111111000111010111110010111100111111111001111111111101111111111110110110110100a1011110011001011101011101111011111011010120221112222222b0220222222220001121a1111
1111111001111101111011011100010001110011011011011111111111111111101111101101111a1111010010011111101111101101001111111111111100222022220a2202220222021222211a1111
1111110011011010110111101111101011111111111111111011111111111010111111111111111a1101101111111110111101111111111111111111120121001120120a2211212222222222120a1111
1011111011110111111101110110001101101111101111110011101011111010001011011101111a0111100111011100110101111111111111111111110111002222220b2211202221212101100a0011
1122022012011221012202211210101110101111111110111011110011011111001111101110111a1111111111011101111111011101110111111111012210022222120b0122022210222212012a1010
0002110101111021021210001211121211010100110100010111111111111110111101110110111a1111111111011010111111011110110110110111112121012020002b2222102202202222222a1110
1122211120202000022200012111222101100101111111111111111110101111011100110111110a1011111111111111111111101111110111111111121221222021222a2222122201022200102a0001
0020101202020012212112221211101211101111110011011110011011111111111101111011111a1011111110110111110111111110111011111011110112000220222b0122211212221212211a0010
1100121210101121200212212221111111011111111001110111100011101011101100111111101a0111001111111111111110101111110011111111021122010012012a2002222202220121221a1111
1102221200211202121121011200010211011111101101111101111110111011111111011111111a1110101111011111111111111011101111111111021222222222220a0221100212222102211a1110
1012021012221021112001220001120011111111111011011111111111111011111111101111111a1011101011111111110011001110101111110110012121220212122b1202001222220210212a1111
1121210201021022222120222222210221211201121121110111101111111111111110111111001a1111111111111011111011111111111111110111111111120222010b2202222222222220021a0111
1102121211121012010002222220202222121220101221111101111111110101101111111111100a1000111111111111111111011110110111101111120222022212222a2222221221222202102a1111
1122121111112212221122120222200212202011122211111011111111001110101111101011001a1111111111011111111110111101111111110110020020212002202b2221212202022201011a1111
1111112222202112022120122210221222222221120201111111010111110111111110111111101a1111011101100101001111111111101110011111111222102220110b2122122121200222211a1111
1100112121012121202222112121022221110122222121111101011121120121211100122122112b1120010111111111111111110111011111111111111022122222012b0212210222222021121a1100
0011100121012110202222201022022210020120111110110110110122012212010121221000202b2211001011110001111011111111111111011111022222122201102b2210220222221022102a1100
1122012001210122202201222020220010202101021101001111111111122100222211122101222b0120011011110111111010111000111101111111121112022211222a0120221222212222111a1101
1112211222122011211010121120222200121112221210011101100102211000210120202010122b1111111101111010100111101110110111111110121122222220222b0222102220211022011a0100
1121010112112021222202122001211220222122120211100101111122112220211221212201202b2011111111111110011011110100110111101101111200001221021a0012212112222222212a0101
1122200211111122221002210212202110222210101120110011111201221010111212011212012a1021111110111011010101111111111111010111101212022120202a2120212222122001102a1110
1122102111011221000212222102122222121211122011111101101020111021210212022111210b1221111111110101111011101011111110111111121210212110210b0001112121212101111a1011
1112120121111212221222011212221101110100211011101111111202011221201110122211110b2222201011111011011111110111011101010110112100200112202aababbbbbbaabbbbaaaaa1111
1002221212212212222121021122121012020022021111011110111110021211121122211101012a12112111111110011111101101001111111110011102120200112121112112221002220110000101
1122111201111012220222122000212112120222201121001111111111202111111101122221112b20121111101101111001111011111111111111011222121212222112111112002221220110110111
1112101022020112121212212102202011102112222201111111111121022110021120221220112b21120111011001111010111110110111111111111112020000002212212100201220101011111111
1110111211212222022122022222122211021120021211111111111222121111102222222021122b12211101111101111101111001010101111101101211122110201021110021111022220111011110
1112222111110211220022202022202220100012111221111111111212020201201110211011221b02120111111111111101110011010101111011011212222122211100011201002020222111111111
1100010221220100220221222222112001211202112101101101111001012210200211212210222a21221110110111111101111101111111001011110221202221101002101211200210012101111111
1102220220201121001200202222212211201011002121110010100222011101112111110101112a21012110001111101111101111010011011110111100101200122202221212122212200120111111
1110022220101112122221210221022222121110102210111111110112020112202201201202201b22222222112201011111001100111011001011111101001101111111111111111121010120100022
1010112221202020122122200222222022012122222201111110011210122110201212020012022b20222221120011111111011111001111011110111111010111101011111111101202212021011021
1122002201201012112111221200222220202122202111111011011012112121202002200222221b22222112102201111111111111011101111010011011111101111101111111111102012211221012
1122001221010210202020210222122020222122211021011101111020111122222222021222120b22122100211111110011110101110111101111011111100111101011111111012222021210211200
1111111111111012021112112121121111002102211221111111101102120022122222200002210b22220102211211101111110111111111111000101101111101010111110110102112121022112221
1111111100011111212201001211121121011001122021110011011201120222220122221222221b22122222110111111110011011111111011111110011111111011111110111112220111122110121
1011100111111112221120022000112102222222012211011111011022212201201222202212212b02202201000111111100111011111111000111011111111111111101111111012121102122200201
0101111011111011212221120022012210111102120220111011111021122101112120020222220a11122102222100110110111110101111010011011111111111111111111111111121020000002121
1111110110111112122101221201212212100210110111110010111211021102222212222211002b22222202012201101100111111111101111111011101001010101001111100102011100122102020
1111111111111001001011201112121220202221110021111101101222210220022221000210212b02212211101001010011111111101111110011011110101011100111111010111212000212221221
1110011111100110101211012121210122200012221121111011110110012102222222220200120b02221210110211011101111110111111101111111111111111111111010100112111121120121221
0110110111111111011111111111111011011111100101111110110112212202022220200222220b21022021212010111111101110011110111111101011011101111111011101012110110201220012
1101100111111111110111111110111101101011111111101101111121220222122122222222220b22202111111111101111101111111100111111011111100110101111101111111011022100121211
1111011111100110111111111111111111111101011100101101111212010220222222112201202a00002102101111111001011100111111111110111111111101110110111111010012111121112212
1111111111111111111111110111100101110111111001101100010111102221221202021222222b21110111110001111011110101111111011111111110001111111111010111111212112110212220
1011111111101010110111101100110111110101111110111111111011011022011221122211122b20121120111111111111110011111101111110111101010111111111011111011221110111012221
0111011111101100111111111011110111111011001101111111001101111021121212001220122baabbbbbbbaabaaaaaaaaaaaaaaaaaaaaaaaaaaaaaaaaaaaaaaaaaaaaaaaaaaaabbaababaabbaabab
1111011111100111111011111111110111111111110011111011111111011002212112101122221112211000120011101100111111111101100111010100111111101001110111110201112211212102
1011111111110011110111111111111111111111111110111111010000101121011020222012211211202120221111111111101110111111101100111011110010111111111111101120221112202220
0111111111101111111011111010001001110101111111011001111111010122110121220212211121121202012111111101110111001011101111111101111111111111111111111122001111010120
1111110111010111111000111111111110111111101111111011111101101021222211211122200202112112121111000111011011111011011111100011101010110111111011110212201202221011
1111111111111111111111111110111110111111011111110111111011111100222012122112002212122021211001111101110110110011101001111111111110001111111011100212021210102021
1110011110101111011111100111111111111111100101110111111011011022120222120101211010110122121000111111111111111111001111111011110011011111111111110222021120022202
0011111111110110011011111001110011111110111101001111111111111022121200122211101021111122211211011001101111111111110111111101111111101111110110111010211112112002
1111011011111101111111111111101111010001011011101111111101110111112121122201111111022222212211011111111111101101110011001111111111110111110101011221110102212020
aaaaaaaaaaaaaaaaaaaaaaaaaaaaaaaaaaaaaaaaaaaaaaaaaaaaaaaaaaaaa110011122121202111200121111121111011111101111110110101001101011110111101001111111101221221111101202
001111111111111111110001011110111110011111101100101101011111a122121111222022101120112001112101111011111110111111110001111110111111111111111110111010120200211122
111010100111100111111111111111111010101110110101001101111111a120210212022202102102212122222110111111011111111100101101001111111111111011101111112010110212222221
101101110001111100110111110011110111101111110111111111111101a112001121122100200112212012222210111111111111101011011011111111111110111111111111112010021212111011
011110110010111111110111011011111011010111101111011100111101a100222122122211212222211111201111111111111111011111011001101000111101011010111111101111111111100011
111111111111010010110110111111011110011111111110110110110111a111111111111111111010111110111000111011110101101111011111011110011111011111011011111100011111110111
111111011111111100111101011110010111111101110011101110110110a11011111001111101111110aaaaaaaaaaaaaaaaaaaaaaaaaaaaaaaaaaaaaaaaaaaaaaaaaaaaaaaaaaaaaaaaaaaaaaaaaaaa
110001111110111111011111111101111111101111110111111001011111a11110110101111111101111a111011111110111011101011111011101111111000100111111111111111011011101111111
011111011111111011110111101111110110111111111110100111110111a11111011111111111111101a111011111111011111111011100001111001111111111011111110011011111111111110111
111011101101111111111111111111101101111111111111011110100111a11010000000111111100111a101111111101111111111111110111111111110111011110111101110110100111111011111
111111000011111111011111001111100111110101111100100111110111a10011011110111111101100a110111111101110010111100101111110011111111011111011111111110101011111111111
111111111111010011111111100111101111101111111101111111111111a11111111111011101001111a011110111111111111111111111101111111011111111110111111111100011101010111111
110110101111101111111100111110111110010111111111111101111110a11110010111110111110111a110111111110110010111110110111011111111011111110011100111110110111110010110
111111111111111101000001010011110001111011111010111101111111a11110101111111001011100a011111101111111111111110110111110110011011010111111111111011111110111100111
001111001111011011001111111111101101111010110011111001100011a10111101111111010111111a101111011110111111111111111010111111011111111111101011110101111100011111111
111111111111101111000110000011111111101111101111011100111010a11111110010111111111110a111011111110111101011110111111111101111111101111110111101111110111100111111
111111111111111111111011111111001001111111101011011111011111a11111101111111101011110a001011111111110100111101110011111110001010100110011101111011111110111011111
111110111111100111111101111101111101011111111101111110011101a11111111011101010011110a111101111111011011111100101110011110101111111111110111111111111011011111111
111011111111111001011100111111011111111111111111111101111111a11011011100101111111110a110101111111101100111011111101011111111111111111111111110011100111111101100
111101101101101101101111111111011001110111111111101110111111a11111010011110111011011a011111101011111111110101101110111011110111001110101111001111111111111111101
111111111111101010111111011111111101101111011111111011111010a10101011111111111111111a111111111011111111111111011101111110110111111111011101101111111001110110110
111101110111110101111011111110111011111110111100000101111000a01111110111111111111111a101111011101111011110111011111111111101011111111110111110110111011011101111
111111111011111111110111101110111011111111010011101111101101a00111011111111011011011a011111111011111111101111111110111111110111111111011011111111111111011110111
101111011111111011110111101111110111111111110111111111111111a10101111111111111011011a011111101011111011011111011111011100011111111011110011111100111001111110111
101111101111111111111111101000111101011101101111111111110011a11111111111101010110100a101101010011111111001111011110001001111011110011111101101011111011111111101
001101111111011101111111111101111011111111111111011111111100a10110011110111100110111a111111100111111111110111011111111011111011101110111111101101111110111111111
110111101110110111011011011111011111101110111111110000110111a11111011011011111111111a101110110111110111110011101111111111111111110010100111101111111111110111110
110001111111111011100111101111111111001111111111111100111100a10111110011111111101011a101111000111110110100100111111011111111111111111111101110101111010011011110
111111111111111111101011101010110011111111111010011111001111a11011101010111101111101a111101010111011111111110010011111111111011110101111111111001111111101111011
101110111111101011111110111111110011010111101111101101111001a10111101001101001101010a100110011110101011011111110110101101111011111111110111011011111111111111011
000110110111111111111011111011001111101110111011011010101001a11101111101011111111110a011111111011111111111111111111010111111111111101110111111111010111011111110
101101111101101010011111111101010010011011100010111011011100a10101111111110111110011a111111111111111111101011110110110011111011110111101111011111111101111011110
111111111111111101000101111100111111111101111111110111111111a11101111111001101111011a111111011111011011111111111110111000111101111001100011001111111111010111101
011111111110001111100011111110101111011011111111111111011111a00011010111111111110111a111101111111111111100011001110111111111111111111111100111111111111111111111
011011111111111111110011111110101101111011111001111110011101a11111111111111111110011a011111111111001111111011111111111111110111110011010101111111111111011111111
110011110111110101111111001111111011111101101011111011110111a10111111111111111011101a111100111111111111101111111100111111111111001011110111111111111101111101110
111111011111111011101101110101111111101011011100001110011111a11011111111101111111111a111011111101101111101111111111110111011111111101110101011100111101111110111
101111111011111111111011101011111101111110011111111101111101a00111110111011111110011a110111111011101101011111111101111110011111111100111111101110110111110111110
110111110111101111101111011101111111011001111101110101110111a11101110011011111011011a111111111110110110111100110110101111011111111101001111110011011101110111111
111111001010011111111100111111111011111001111001111111011111a11111111111110111110111a110100110011111110111011111111011011111111101111111111111100110111110111111
111111101101111111101111111000111101111011111111111111111101a11011110111111111111111a111100000001011101101101111011111110111111111011011111111111111111011011110
101110100101000111111101101111111011111111101111010011101001a11011111111111101010010a011111111011111111011111010111110101111111111110111011001111110110111111111
011110011111100010010101111101101111111111011111010111111111a11001111111111111101111a111001101011111110001100011111101111111111101110101111011011111110100111110
111001011111111100011111111111110111111111111101111101011111a11110011101111110111111a101111111011101001111111111111001101011011101110111010001110111111111101111
111010111111111111111101111111111111111111111111011100110011a01010001111111010111111a111111101011111101100101111110101111101111000011110111111010111101111111111
111111110111011111101111111110110111111011011111111100101101a11011001001011111111111a111111101111110111101111101111011101111111111011001111101111111111000111101
111111111111111111110110110101011111011110111111111110011111a11111111011111110110111a110111111111111101111110110011011110111110110111100010111101111111111111111
