(123, 87)
(7, 0)
(53, 20)
(123, 2)
(37, 79)
(97, 42)
(120, 107)
(100, 78)
(2, 63)
(94, 18)
110101111111001110110222121b22221211001112112121022111111111111111111111111111011111100a011111111111101111111212111010211121100211020122110111101a111a1111101111
011111101111111111111202200a21221221122010120110010101010110111000111111010010111010111a101111101111111100101222110011212012112111202221011011101a111a1011011111
111111010111111101110221112b22122202121221120122002111111110110111110011110011111011111a111111111111111111110011012210012111001222121002221110011b202a1111121012
101110011101111110000120112a10122002022212102012021100111110111111011111111001111111111a111011100111011111111211022000220122101212101121110111011b100b1121102221
000011011111011111110201012a20101121012211102020201101011100111111111111111111001111111a110110011111111111111121002101222110212021102112110110101b221a0202222122
110111111110011100111100111a02211221120011202120012110111101011111000111101101111010001a111111111111011011011211022120222011112101001212121111111b210b0201011010
101101011111110111011012202a21010012212112221202111111111111111111110111111111011110101a111111111111111111111122110011220011011121021220021011012a002b1222000020
110110111111011111111202010a22012112110211020121022111111111111001100101111111111101111a111111111111011110111022201222222221211122110202202111112b020a1002002021
010111111111101111111222010b12210000200120211122122111111100100011111111111110101011111a111001111011101110011022211220212220011221010220122101011a120b1120221120
111101101111111111111221202b01021200220212022221121200111210111011101010111110111111110a011111111111101111111210122211012121212122201001010111102a111a2121121100
111110111111110110111010222b01021000022002120212020021211111100111111111101111011111111a111111110110101001111222122201122121111110210212001101110a102b2201202122
001111101011111111111102000a02022210122212210222202111100001110111111111101100111101111a111111111111111111001102212212121121010222022002110111111b102a2020011020
111111011111111101111211221b22122122200222222122012101111011111001110111010110101111101a111110101111111110111012001112120121112001001221212011111a121b1212112200
111111111111011010111220112b12220112012122222021222202222201011101111111010111111111111a111101111111111111110021201111102110000102212221011110112b211a1001211000
110101111011001011110211222b22222210221122222021222212211011111111111000011111101011111a001011101111111111111221111011121221101221200122202101102b220b2212002221
111110111110001101011201021b21212212222122212100122002121011111111101111111110011111111a111111011111011011011122211011201202221122100202111011011b121b2121120201
101111111111111101011210212a22222222012102012012222221002201111010111111111011101011101a001101111111101111011201012001111211212021011022112011112a222a0120021211
010011111011111111111211020a22222212021222222222220121202011111001010111011111100111111a101100111111101111101201121120011012112222212201022111010a012a0101021211
110011011100111010110002121b10020222122212220222222221200010110111011111101111100111101a011111111111011111100002211000021010112212221222111011110a120b1122201220
111001111111011111101011111b22002112222220212202222102222200111011111111101111101111111a101111110111111111110022221211222201101112120212121100100b120a1110202220
111111100011111100111110121babbbabbaabbbbbbbababbaaabbbaabaaaaaaaaaaaaaaaaaaaaaaaaaaaaaa01110111011110100aaaaaabaababbbabbbababaabbbbbbababaabbbbb212b1021222201
001100011111111111101221212121122112122222120222222201000001110111011111111101110000111111101101111101101a1002220012210220212120201222220222122002221b2201220201
111111111111111110011102112220010202121222222222122121221110110101110111111111111011101111111111111111111a1112220121111122110202002201222020100022102b2221220112
010011111111111111011211111120222012210012222222010122112211111101111111101111101111110111111011110111001a1110122021012121202200122220212202120002121b1221222212
111110111111011111101102201212210112212202022022002221120011111000111110011110011101111011111111101010111a1110222212222212022201222221022222212222002a2220102221
101111111110111111111212112112222202212202220122122100000100111111111101111110110011110111010111001111110a1102121020122020211212200202222022111221001b2202020100
111111110011101011000010012200200120222022022221122221110211111111111111111101110111111011110111010111011a1111122112212010010212122022022221021222201b2022222211
111111001111111111111111102122202021120102222202202121111211111100111111111001111101011111111011111101101a1111001110221200220110022021122221120122222b2022122221
011100100111110101110101111122112121011020102122112112022011100011100001111111111011111011111111011111111a1111111101010001011110121110222110220122201b2122222201
111101111101111111111011111101110022211102122101022212112111111111111110011111101111111111001011111101111a1011011111111111111011012112102220221220201b2022002200
101010010110101101101111111102101121212002002211001221012211101111110011111111111100111111111111111001110a1111101110111011111111002010121202210202212a1120222011
100111111110010111011110111112120201201221112011100212202111111111111101011111011111111111111111011101001a1111111111110011111111102222022020122222012b2211212201
011101110011011110111111011022111211012111012112222122122110001011111111111111111111111111111111101111111a1011101111011101010101221221222221122222212b1220121210
111111111111110111111111110010020112112122212102111121212210010110101010111010101111111101111000111011111a1110110011111111100011012210101100121220211b1002210111
011101101111111111111011111101211110122122012221220210212211100011111101111000011011111111111111111110111a1011111011100110011110012212220112100210110b1002122101
110011011101111011110110011102001020221202122212221221112111111001011111011111101111110110111011011111111a1010111111111011101111211111212202211222220a2222102210
111101111111111111001111011122122201012021122102201212212000111101110111111101111101111111110110011111111a1111111111111111110111112211110220120212212a1212122111
111111111111111100101111111102122112112111202021011101200211111111111111110111111011111111101111111101111a1111111001111110101011012221112200120102122b2111122100
110110111011110100111100101120012101111101121210122011212111111111111111010110111001110101111111111111011a1111111011010111011010222010101220110021021b1221001110
111011111001110110111011111110111110111110101101110111110111111110011111111111110111101010110111011110110a1111111111101111111001212121110210112222120a1202111101
111111111001110110111111010111111111110011111111110111111110111101111010111111111111111010101011001010111a0111110101000111111111121112102212011222112b0220121101
111100111111111111111111101010111101011111111011111101011101111111111111111111111110111110011101001111110a1111101111001110011110110102011211212012221a2100102010
110111111111111101011111101110110110011111111111101110111111111111111100101111100011111101111111010011101a1111111111111111111111121021110021221110222b1000210110
110011111100011011111111111111111110111111111111101111111110101010111111111101011110001101111010101111111a1111101010011100101011010102121021110020222a0110120011
111111111101010111101110011111010111111111011111111011111011101101111111110111110111111111101011100111000a1111111110111111101101100122020111101122220a1221121111
111011111111011011011110111101111111111010101111100011111110111111111111111111111101111111111111110101110a1010101001011000100010212111022110112121121a1112122201
011111110111111110111000111111111111111111101110111111101111111011111011111111011111100010111101011111111a1011001010101100111001102121100022021012211a1102112101
111010111111111010110011011111011101111111111101111111111111111111111110111011111101101111111101111111111a1010111111101111110110112102212011112122221a1221212211
110101101111111111111101110110111111111111110111111111111111110111111101110111101111110111111111111111111a1111101110101111011101212121022221221110212a1102110111
101111111001111111111011011110111101101011110111111110101111111111101111111101101101101111111111111011011a0101111001111111100111011222202112021111112b1110001201
111011111111011110111000110111011111110111111110111101111111111111110011001111011111011111111111111110101a1101011111111111111110011110110111111010111a1001011101
111111111001101010110111101111111111100101111011101110111111111111111101010111101111001011110111110101110a1110111100111011110111011101111011011011110a1011011111
111011011010111111011101111101110101010001111111111111111111101111111111111111110110111110111111011111001a1110111110110011011110111111111111111101110a0011111001
111111111101100101111011011111111101011110101010101010111111111000011111001011111100111101011111101001010a0110111111011111111111010101110111110111101a1110111111
aaaaaaaaaaaaaaaaaaaaaaaaaaaaaaaaaaaaaaaaa1101010111111111000110110111010011111111111110111111111111101110a1101111101111101111111010110111101111011111a1111001110
1110111101101011111111100011010111111110a1110111111111001101110111101111111111111111101100110101010111110a1110110111110001111111010011110101101110111a0011001111
0111101011110111111111111111110110111110a1111111111101110011101111111101111101101111111011110111110101101a0111111011100111101111110111011111111101110a1111111111
1111101111111111001011111111111111111110a1111110111111101111110111101111011110111110010111111111111101111a1111111111111111111101110111111110111111011a1111110011
1011111111111111111101111110101111101111a1111101000111010111101111111110101111111111101011111111110111111a1111111110111100110011101011011101101111110a1111010001
1011101111101111011111011111111011111111a1110110111010011101110111101111101110101110111111111011212200220a1201211202112121211011111111101011011101011a1100111111
0111111111111111101010010110111110111110a1111111111111111011011111111111101011111111011111111111111121102a2012221121112221112001111100111111111011111a1111011110
1111101111111010111111100101111111101110a1110111101101111111011001110111111111100111111111001111110112122b1100201112222102102111111111101010111111000a1111110101
1011111100111011111111011101110101111111a1011101111101011111111010000110011111111111111110011102102111002a1202111112120012221111100111111101101111111a1111101111
1101111000011111111001011010110001111110a1110011011111111111110011001101111011111101100110101111221221102b1211111120211010122111111111110111110111111a0110110111
1111111111111111111111111111111010011110a1111111111110001111111101001111111111110111111110111101021010200a2201122121112011111111110011111111111111010a1110011111
1101011111000101101110111001111101111011a1111110111111111101010111011011111111111111110101111102122220222b0002222012212222120011111111111111110111101a0011101011
0111111101101101111101111110110101011110a1100111111011111111101111111110011111111101101011111100122101222a2022122222000100111011111111101011100001111a1110111101
1111011001011111111110010111011111111111a0100111101111111011111111101111111111111101010111110012100210222a2111220221112112000001111010111111111101001a1010011100
1111111111111011101110010011011110111111a1111111000111111111111111001011111110010101111110110111002201110a1121121222101211011110111111001100110100010a1111010111
1101110111111100111111111001111111010011a1111111110010111111011000111111110011111111111110111111222021122b1102211211011011212111011101111111101111110a1011111100
1101110101110111101010011101101111101111a0101111111111011011111101101011001100111111111111111101202210111b2211101121212001100111010111111110111111101a0110011111
1111111111111011011111111100111100101111a1111110111111111111011111111111111110111111110011101111221221122b0121200120202021122111101111111111101111111a1111101111
1111011110101101111000111111111100011100a1111101111110111110101111111110111111101111011101011111212112200b1102100210121222122110111111111101100111011a1111111101
1111111110111111111110011111111111111111a1111101100110110101111101111111001111111111111111110112121102221b0222212122012111111111111111111111111011101a1110110111
0111111011101111101111101111111111111101a0111110101110110011111100001111111110101111001110111111211010001b1111102222201102211101111111011111110111111a1110101110
1111111101111011101111011110111101111111a1111111111101110111101011101000110111111101101110110010111112110a1111212121012221112100110110110011110011111a1011111110
1111111100101001111111110100111111100101a1111122221010111221111112222222202201100010111110011100112101210a1111102202121222112111111111011111100111111a0110110111
1001000111111110101110101111101101111110a1111110112222010110120221100011022111111110011111111112120101001b1210112122021001100111101001010111111111111a1111010111
0011011111111111100111100111111111110101a1111002111212110020212221222122221110110111100110110110220110201b2010122122000221220110011101011101101111111a0100111110
1011111111110110111110111111010011111110a0101012020121211100212110121122112011111110011111011110201212220b1102000221212210120111101111101101111110111a1001010111
1110111100100111011011111111111110111111a1111011112221111110021211012200122101100101110101101101100111121bbaaaabaababbbbabbbaa11111101111011101111111a1111110111
0110110110111011111010110111111010101011a111011220221011112222121121212210101110111111100111011012011212211111221211201201222a01111111100100111111111a1101111111
1111101111111111111111111010110011111101a111000221201222120122201221012112111110111101110111111211010211100100122212220120211a11111011011111110111111a1111110011
1111111111010111001111111111111111111101a001011100221012012112111212022211020110110011111111110112212112120022211120001222221a11111111111111111110110a1111011111
1110111101101011011111111111101110111011a110112022222121212220202120101112220101111111101110111200121111201211121021021201221a10011111111111001111111a1111111110
0101111110011110111111011110111111111110a001111122112112121010021121112210111111111101101011111012111102122202112210212122221a11110100111110101111110a1101100110
0111110011101111111110111011011111111111a110010102112111211222002100102211120010110011110011011220220221101021200020012211010a01111111101011011111001a1111110101
1111000111000111011001111111111111110111a101112001001120021101010222211211221110001111111011110011002202211212201222022021122a20201101100001110101111a1111111101
1011011111001011101001110011101011111101a111111212201111012122102200120122221111111110110111110121101010212220222122222112022b22202202122111110111111a1011111011
1110010110100110111011101101011111101110a111001222021121222121211010120222111111111111011111111011011101011122202110201122012a11112110021101001111110a1111111011
1111001111111111111010010100111101111011a111111112112212020111212221222122111111110000111111111010111010101121112111110221120a00212012122111110110110a1101111111
0001011110011110111101110111110101111011a110111102111021122022221122122120120111111111111111111111111101111111101220110221221a12121212212110110111111a1111111011
1110111101101001011111111111111111111111a111111222220221112022212201201222021111110010101011000111100111110111012122111222222a02022210222211111111100a1110111111
1110111111110011111111111111111111011111a111112220222222002222011202202111121111101101101011111101111111011120211120001121011a11011221122111111101111a1111111010
1100111011111010111011110110111111110011a111112022012220120210121202210122220100111111111111110110111111111022112022112112212b12111111102011111101110a1111111111
1111111111110011111111110111110011011011a011100122102201112112111221201221111111111111101111010111111110111120200110021122202b11222212212111111110101a0111101111
1111111111101100111111101111111111111101a101111222020111211202122220122100111111110011110111011101111101001112121200201202112a02201221221211111111111a1100011110
1011101111111111101111111111101110111110a101101212101011000222111222121121000111011111010111111111000111010110122112221202211a12212012222101111111111a0111111011
1110111000111111110011111110110011111101a111112122122222220020122112110001211110101110111110101010111111110120201002212022111a01121222210111111111111a1110111110
1110111110111110101111111011111011100111a001112212211211120220102112121122211111110010111111111011101111111111020002021222120a10012122111111100101011a1001101111
1111111011111101011110111111111111111111a111111120122011201121111102111112211111111011111101111110111011111022121121212211222b00000100210210100111111a1101111111
0111111111111011111011111111101111011011a101111010001021101112001000102210121110111111111110111111010111011102122111222120120a11211101022211111101111a0101011110
1001111111111101111111011111010100011111a111111020020101012121102022012111221101110001111110111011111101011012112221212001212a10212110111211011111011a1110111111
1011111111011111011111101101111111111111a101112112011021122122220012211112001111111011111111111011111101111110201212222021212b01112020202210101110111a1111101111
1101011010110011110011011100011111011111a111112221211102112000121220111111111111111111111111011111111111110101111112210210222a01101112221211101110101a1111001110
1011111101101001111110111011011110110111a111102001012210020220211112210112010000101111011111111111111111110112111112011120012a11121221202011101010101a0111011101
1010101110111111011010111111111111010010a111111111110001111111001111011011111111111100111011111110111111011102201201021212212a01212220100111111111011a1111101101
1110111011111111001111110011111011100101a110111101111001110001101110110111110101101111101101011110011110011122111010111222200b22210122201211101111101a1001100111
0011101111111101111011101111111101111001a111111111101111111110111010111111111111011111001111110111111111101122120112111111011a20022210111101111011101a1111111101
1111011111110101111111111111111110011001a111011011111100111110111110111011100101011101111111111111111111111122211122011110111b02202222212211001011111a1011010111
1001011111111111111111111111100011111101a010110001111101111101111110111111110110011011111111111110111111111122120101221200022a00111220211010101111011a1111111010
1011101111111111011111111110111111010011a111111111111101111111011101011011101111010011111111101101111011111011012111222110222b01211122211111111101011a0111101100
1111111011101111101101011111010111111111a011111111111011111110111011101110010101111101011110111111101001010110122201112211121b12121222101211101101111a1111011111
1110111010111111111111110101011001111111a111110101110110011111101101111111111100111101001101101111111100110112112221021211212b22221221121111111001111a1101100011
1001111010111111101011101011001010111011aaaaaaaaaaaaaaaaaaaaa0111111011011111101111111001101101111111100111002200110210201212a11222221120111101011011a1111110001
101110111111111110111111110100110100111111101101001011011011a1100110111001111111111011001111111111111101111111102110012112112b12212112102211111110110a1111011011
111111011111101101110010100110110111111111111011100011101110a1111111110111110001110011111101111111111011111100212211021210122a10112011120111010111111a1111111101
100011111111010101110110001101111011101110010111111111110111a1111010110111011000001111111011111111111111100011111101111110011a11011111011011110110111a1111100111
111111111111111111111111000111110011111111011111111011011111a1010111011011010111111001011101110011011111111010111101111111011a01111111111011000011110a1111111010
101111111111111000110111111111111111111111011111111111011011a1110110110111111111111111011111011101111110111110011110111111111a01110100111110111111111a1011110010
