(19, 97)
(137, 20)
(138, 53)
(13, 106)
(122, 107)
(39, 68)
(126, 48)
(66, 4)
(75, 76)
(58, 70)
1111111011110111110100111111111111011111111101111011121201112221110122222001212101101111111110111001111110111111111111111110111111111101101111100110111110111111
0110011100001011000110111101011011011101111111111110120111112222101002121002120121011111111011011011110111111101011111011111111111111111110111111111111111111100
11011111111100111111aaaaaaaaaaaaaaaaaaaaaaaaaaaaaaaabbaaabaaaabaaaabbababaabbbbaaaaaaaaaaaaaaaaaaaaaaaaaaaaaaaaaaaaaaaaaaaaaaaaaaaaaaaaaaaaaaaaaaaaaaaaaaaaaaaaa
11111111001111111101a1111111111110110111110111111110102210211012201112002222002020110101111110110111111101110011101100111110110100111111011111101111111110101110
11111010111111110111a1101011111011011111111101111100211211001222112222002222110121100010101110101111110101111111111011001111011111111011111110011111111011110110
00111111110110000101a1111011111111101111110011111101202210022210112122212111110210110101110111001111011011111100111111101011110111111111011011011100111101111111
00111001110111110010a1111111111111000111010111011111101122122221111211001022202201111111011101011100100100111110011111111010101011111111111100011110001110010111
11111111111111111011a1010110011011110111110111101111211120122210212010121222122011110111111111100011110111111110011111111110011011101111111111111011111111111101
01010101011110111111a1101101100110111011111111101101211120112110112110212212011221101111011111111111111000111111011101111101011111111111101111111101111111111111
11101111111111001110a1111011110111111111101101110012021212112121112222201122222121100111111111011111011111111111001111111110111011000111110101111111111011101111
11111101111111010111a1011111011010111111110111011112100111020111222120210112111021110111111111011011101011111111101001111010011001110011011011111111111101110110
11011111110111011011a1111111111110101101111101101110120111110012210110112111020101111100011011111011101011011100111111111111001111111111111100111001110111011011
11111110110111111111a1111110111001111110111011111111010102120221110121212000111201111111110111111111111101111011101100111111111111111101011110111110111111111111
11011110111111111111a1111011111111011011111111111111021011221012121212111222111121101111110110110011110011111011111111111111111111111111111001110111111111110111
11111111010110101101a0111111001111111010111111010011120110201221021220220211101210011111111111111111111111111111101110111011111111111111111011101111111011011010
11111111111110101011a1111111110111011111111011111011122221201210012202111112002120110111111111111011111111111111001011111111111111111111111111111011001011111101
11111011110011110110a1111111100011111111011101101010212021121111022212100212210221001111110101111011111011111111101101110111111101111111100101111101111101111111
11011010011111111100a1111010100101011011011101110110121200121222120121122122001101111111111111101111101000111111111010111011111111111111001100110101111111111111
11101110111111001111a1111110111111111100110111111111001221122200022222112100220001101111111111111111111101101111101111111111011111110101110111111011101111111011
11111110011111111101a1011110010111101011111111111111111111011111011011111011111010111110111111111011101111111110111111111110111110111111101110011111111111110100
11111000110101111111a0111111101111111111111111111111100111110111011011101101101111111111111110111111111111101110111110111111111101111000111001011111110111100111
11111111111111111111a1111110111111111111101110111100111111011111111111110111111111101101110011111100111111111111101011111101111011111111111011111111110111011011
aaaaaaaaaaaaaaaaaaaaa1111011001111101111001101111101111111111110111111111110111001001111101101110101010110111011001000001111111111111110111011011110001111110110
1111111101001001111111100101111011111111110111110100101111110111111111111111001111101111101111010010100111110110111111100111111111111111111011101110111111111111
1111011111111111111101110111100111101111001001101011111100110111111111111101111100110011011011111110011011111111010111100111111111111111111111111100111010111010
1111111110111111111111011111101111011111010110111111101111111111111101110101011111101100101101110111110101001111111001111101111111111111001101011110111011011111
1111111111111101111011111011111111001111111100111011110111111111001011111000101111111111111111111111101111011001010111111100111101010101111111101010111011111101
1111001110110110111011111101011101111010111110111111011001111111101111111111111101011111111110110010111111011111111100111111111001100011001111011111111110010101
1100111110011110101111111101011011011101111011101111011111101100110101111001111110111111011110011110011111111000010111111111111011001111111111111011111101101011
1111101111101111111111111111111111011001111111011111110111110111010111011101011110010101011111001111010111111011011110111101101111100111111011111101111111110111
1111111111010111110111011111011010111011111111111010111111111101011111111101111101111011111111111000101011111111111111111101011111011111111011111111110111111111
1111111111011010011111010100110011111111111010110110101101011011111100111110111011011011110111111111111111111011111111011111111111111111111111101101111101101011
1110111011101110111101101011011111111011111111100101111111011111101111111110111111111111100110011101111111111100101100111101111110111111100010111111111111011010
aaaaaaaaaaaaaaaaaaaaaaaaaaaaaaaaaaaaaaaaaaaaaaaaaaaaaaaaaaaaaaaaaaaaaaaaaaaaaaaaaaaaaaaaaaaaaaaaaaaaaaaaaaaaaaaabbbabbbbbbabaaabbbbaabbbaaaabaaaaaaaaaaaaaaaaaaa
0001110110111101111011101000111111010101111101101111111110110110111011111111111111110111111111111111111101111111121112201112011110002020202000110111111111111111
1110111111100111011101110111111111111100111111011111110001000011111110111111101110111101101101111111011111011011221102222110111022020111100001111110101111111111
1110110111111111111101001101011111110101111011110111111110111110111110111011111110001101110001111001111111001112121211012212022100212111112121110111011010110011
1011100111011111010111111111111110111110111011111111111010010101111000101111011111111101111010110011111111111111011022012211121120211122200221111111101111111111
0001111111101011111110101010110111101110111111101101111110111010110010000011101110101111101010101111111111011112221002111112222222121200012021022120221211111111
1111111001111111110110111111001111111111110101101011011101011111111110011011110111110001111111111111111011101112220201110001021212102112222221220202101020111100
1111100110111111101111011111110111101011110010101011111011110111111111110011110111001101110111101111111011111111012102120121220002210221220020221221101020101101
1111111110101101111001001011110101111111111001111111011111011111111111111111111111000111111110110111111011111111022202210212222222122222120112211201220221111111
1011111111111111111010010001111111101111100110111011111010111111010011011110111011111111111111101111111011111111202201212001222112011222122111121201010221111001
1111010110110101011100010011111111111111110111111101101000110011111111011011111001011111111111111111111111111111212121102122012020100221120222211021011121111011
1111101111111011011101111101011111111111011110111110001111111011100110111011101111010011110111111111011011101110212212121222220120200211112220111211121221011111
1111111100110111110011111111111011111111110010010011111111101110000010011111111100001101111111110011111110111110111111121121211102022222122012212201200110011110
1111100111111110111110111111011111111110011101110110010101111111011110111111111110111011111111110110111111101111001202111112222020122122221012122202012201111110
1101110111111011111101110111111111110110111111111111011101010111110111011110110111110111111110111111000111110110222101011120210221020201222111121100211221101111
1111101101011101100111111111101101111111111111101111101111111110111100110001110001111110111101101011000111111101221120001122101012122220210101202121101121111111
0110111010111101111111110111010011111111110111111111110111111110101111010111111101011110011011111111111111011100121112222120221222202112210222111110000211110111
1110010110111111111111100111101111111111111111111011111110011111011111111111110111110101101010011111011111110111020222220110022222212222212222220122022111111111
1111101111111111111110111111111111011111111010111011111111111111110001111110110011111101101010111111111111111112222111210100220020212221102122211111222221111101
1111100111111111101111111111010011101110011011100110111111111111110001110111111111101111111111111111000110111111100012221101001012212222020200021111102201111111
1110011101001101110111100202221201211101121122021111210011111101111111011101111010011011110111100111101111111111221201100022122020112222222221112212202121111111
1011111111111110111010011102122001202101001122220110121111111101011111111111111111111001101011011110101111100110222222112121122222112222222221122012121211110111
0111111110011101001101112121220121220012111012002212211211212200111212220111101000011101111111011111111011111111012112211210222102020100222201120222111221111111
1011111111101111111010111112122122020121210212202022121100221021111122121111101010110111011111111111101111011111112101111122210222022210222210121222001210011111
1111111110111100100111001110122022202012210121101022220212011011022101221111111111111111110101001101111011000102211211011212122222220200202220011111110211101111
1111110011111100110110112221212221120212011202122201212012001122211212122011010111011101101111101110101111110011221222222222222221211220102222212201122111011010
1111100111011010110111110110022122212112101222020222222212120120202002222111001111110101111101101111111111111011102111000102122012002022212201221201220211111011
0011101111100110101101102212101101102121100202020002222120200000221221202111110110111011111111011111111101111101222022111012012012002210221201211112122221101011
0100011110111110110111111011112112212201011122222222220211211220220220021102212112100211220011111111110111111110022101001012212212012022002222222201202021111111
000110101111011111111110111222210202201212220221012201012221bbbabbbbbbbbbabbabaabbbabbababaaaaaaaaaaaaaaaaaaaaaabbbabaabbaabbbbbbabbbbbbbabbbbbbabbabbabaaaaaaaa
111101101110111011101111112010010101222002122022122022222121b202022222211221002012201101211110111110111111111011111011001111000022221011020111211222212211011111
110100101111111111111111221112122112200120221222122202000211b002022022122212220100212121001111111111011111011111011111101101122102111222121211122120101000111101
111111111110111110111111021120121221012211202120021211112012b222220202012212100222110210210111111110110010101100101100011100212022210101212101211201011221110011
111111111101111011000110202020120122021102101220221022011212b021222200122121020012120012120110111110111111111101111111111111211111212122112122101012221001111110
011100110111000011111111202220211210111111222022221120210221b112222222012010110121121110021011111001010111101111111011111112100201122201122021212111122121111011
101111010101111111111011102021211100211121202222122102110221b212222002122221001212121220121110111111101011111011111111110011111101011111101101110011111111111101
111111110110011100101011211220211201011221010021210121220202b020222221222110120211210112121111111110001110111111111011111111111111101110111111111100111011100111
001111101111111111001111121111222212202222112210210222001121b022222022220212110122202201011111111110111110111101111110111111111101110111111001100001010010110111
111101011110111111111111021112211110121122022221222020211211b220212111120020110221022111221110111011100111111110100111011111111100111110111111101011111101111101
111111111011111111111110212121121212210110022102002222000122a100212122222121121120022212111011111111111110010001111001011010000111110111011010111101111111100111
011101111111001101100110211222010212012011100222022022112112b222112102202010212122211120111011001110011111100111111101011110111101111111111011111101010100011111
111111001101011111111111022111121010202011222222221122211210a112102022022110021111220222021011101101111111101111101111111111111100001111110111100011111111111110
111111011100111100111011221121100202112121212002022211220201b002220222210101121220212212211001011110011111111110111011011111011111110111111010111111111111001011
111011111101010010111111120120102222201121021002200221112211a022112222012122120222200112021011011110101110111111111010010101111111011000100111101111111110011011
111110111111111101111111211211222221120002122222012020201201b112221122222201122111012022010011111011111111110111101111011011111011111001001011100110101010101010
101011111110110111111111220112110101121020210221220120100212a122210120022121112211222222121101011111111111111110111011111011111011111101100110111111111110111111
111111111101111111111011222122112011122002202221210121102212b2222102200021211212121202222111111111111110aaaaaaaaaaaaaaaaaaaaa11101111111011011111111100111101011
111100100111111101011000011211002221011102201021222220121111b1220020202020220011112112202210111010111111a1110111011110110000a10101111011111101001101111111100011
111111111101100001011111101202122111222212102220222220212221a0202200202221011100221221012110111111110111a1001100111111111001a10111111111111111111111111110011110
11101111111111111111aaaabbabbbbbabbabaaba2220211221122201211b2212120022122220111012221111100111111111111a1100110111111111111a11111011111111011111111010101000101
11111111111111111111a1111111111111100101a0121222211202111200b2020122222112021012111021200211111111000101a1101111011111111110a11111001111111111011101100111111111
01111011011111110111a1011110111111110011a1102121212110020211b2120122022221112112102021120011111110101011a1101001111111111111a11011111101111111110111111011101111
11111111101111111111a1111101111101111110a0111111011101111111a2111220200202112210120112101210111111001110a0001011101110010110a11100000101001101100011100110101101
01101111100111111111a0101110000111110111a1111101111101110111a2200012212210201111202212222210111001111100a1110111011110111111a11101111111111011111111011110010110
01111011111101111101a1101110011011111101a1111101101111011101b2201000221222211020210120200200110011011111a1111111111111100111a10111101010111100101010111111101111
11111110010111101111a1000111011101111111a1101111111111111111b0211122210210010022222112111210001111110110a0111100110111001111a11110011000111111011101111110111111
11110111111011110101a1111111111111111111a1101100110111011111a0201220021010112122111121220211111101111111a1111101110111101111a11011111100010111001101111111110111
11010111110111011111a1110101111011111100a1111110100111111111a2012112001021222122220222120211111111101111a1111111111011111111a10111111111111111101011101111101111
22111102121120202120a0110011001111111011a1110011011011011111a0011111100101101111111111111111101110111101a1010011110001111111a11111001111011111110001111111110111
22201201212121212001b0102110111111110111a1011110011111101111a0111111111010001101010111111011111111101111a1011111222221012221a21011222010110011111101101011110111
02211110120222112011a1010121111101111111a1111101111000111100a1111010011111011111111011101110111111101111a0120221200002212212b00220011100111111101111111111111011
11202012101022201222a1021221111010111111a0011111110001111001a1111111101111111001111111110111110001101111a0111222201010110020b21210021121111101011111111101111110
10120221102122101210b2122220101001101111a0011111111111111111a1001111110111101111111111001111111101111111a1002222111221222120b12210122202011111111101110111111101
20110122112022210201b1210020111111100101a1010111111011001100a1100111111111110100111110011111101111011011a1010102221210122102a01201120112111101011111111111111010
12020212021102212111a1221212111111101011a1011111110101111101a1111100110111111111111110111100111111111001a1102121110122021102a11221011122211101001111110111111010
02112201111102212112a2022102111011111111a1111110111111110011a1111111111111111100111111111111111111110101a1112002102211102220b22122112222111011111111111111111111
10220102222211122212a2201002111111111111a1111111100111111111a1011111111111000111111111101101110011101101a1121221220100222201a21021222111201111101111110111111011
21112221101101021000a2000122011100111001a0010101111111111111a1111010010111011011111111001110000111111110a1110120202102220111a02212021120011111010101111001111011
21220121022112221211b1111110111011100110a0110111101111010111a0011111101111111111110111100110110111111101a1122201200110121111a00112001112211111100111111101011110
abbbbbaabaaaaaaaabbba2101210111110111101aaaaaaaaaaaaaaaaaaaaa1111011111110111111101110110101110011111111a1002122111211012010b21021120201201111111110111111011101
02122211021002100212212021011111111111110101111110101111010110111101011111101101111111111011111101011110a1122112022210002112a21212221222110011111010111001111101
12021211010212121112221221221111100111111111001110010011111001111101111011001011111011111111111111101110a1121102122020122222b11011121121211111111011111111110101
12222220210212121020222120121101110111110111101111011111111011011111011111101100101011111101101010111010a1110020122222220012a22121121221011111110101111010111111
11122021202022110202201211010100111101110110011011000111101111101111100011011111111111111111011011111101a1120212101121122200b21121121222211111011111101111101000
00112212102221022112011112211111111110110110011110111101111101111100101111011100011010111110011110111111a0101212201212210122a01001212001111011110111111101101111
12211122111212220022122112201010111111111011111111111111011110011111111011111111011110001011101011101010a1102120212021211122b22212012021111111100110111100111110
21212220101110122011111212021110111011111111111101010111111011111010110110111111101011101111111001111110a1122020002111012211a01220220102011110111111010111101111
11211221221210102121121122121111110111111111011101011111111101111111111111101111011111101111110101111111a0112100111112221012a22212122120201010111111101011110010
22112022121122120021211022011010111111111001111101010111100110111110011111010110010111111111011101100100a1122220102022211221a12112011220201111101111011111111111
21111011121221001102212221201110111111110111111111001011101110110111111111111101110011101110111101101110a1112122102121201102b11221201100011111101011011111111111
00222022111101112011022012221010011101101111011111111011111111101111111110111011111101011110101111100011a1122221101220121111b11210111120111111101111001100111111
22212110221021200111201011220111100111111000111111111101111111111111110101111011111111010111111111011111a1010201112220220021b22222012002111111111110111101110110
22222112111222122120211111210111011111111111110001110111001010111111010111110101111011111001101111111111a0122200012120110222b00020122022211111110111111101100111
20112120110010220021122201221101111111111111111011111101110011110111101111111001111110111111011010111110a1020010120212122121b10011011212110111111110011101111111
22202201220011221102102221211111111011110111111111110111010101011111111011011111001110111100101111011111a1120021112021110122b02201110120111111011101011111111111
10111221101210221001011201221011111111110100111111110101101110111110110101001111110111111010010111110110a1100122221222120020a12122122111210111111111011011111011
02112220212111212012222121011111101100011101111111111111111110010011111111111110111011011011011111111111a1000110002122011221a21111011212111011111110100101111011
