(146, 19)
(4, 17)
(112, 62)
(118, 41)
(15, 40)
(48, 105)
(82, 55)
(19, 19)
(134, 28)
(127, 92)
0111110111111111111111111011001011111011111110110111111110010111111111111111110111010a01111111111111111111a1110111101101110111a110110111101011111011111111100111
0111111101101011111111111110101111110111110111111111111111111101111111100111011101110a11101101101101111111a1011110110111101111a101111101101111110110101101110110
1110011111111110011011010111110011101011111111111101111111111101111111111000111101110a01111111111101111111a0110110111111101101a010000111111101100010111110111111
1111101111111111111111111110111011101100111111111111111111111111110110011111111100101a11111101101111110101a0111111111111011111a111101111111111110100111011111111
1101212211111011202012011101211012111111111110111110101011111011111011101111111110101a10111111001111111000a1111100111011101111a101111011011110111111111101111111
1111122122220010111200222201220122010101101111111010111111111111111111101101011110110a11011101111000111110a1111111111111110000a111111111111111111111111111111111
1011222112111000111212020111101111101111111011101011111110111110111111111011001111100a11111010111011000111a1111101111111110110a001101110111111111111111011101111
1011122221202210212212212212111001101111111111011111101001111111001101110111111011101a11110011111111111101a1001011101111110110a111111110011011101110111111111101
1100112222110021212022122211012121011111011011110111011111111100111111111111101111111a11111111110111111101a1111011011111111011a111111111111111101101111011111001
0111202211201121212220201212001120111110111111101111101111110110111110111001110101110a11111111101111111111a1011111101110011001a111111110111111100101111111111110
1111211220100222201212202020121210111111111111001111001110111101111111101010111110011a11111110111001111101a1110110101110011111a110011011101101111101110111111001
1111101002212011101012112022001110101110110011101101111011111111010111111111111111010a01111100011110000111a0110111111101111110a010100111111111111100111111111101
1000211122022222012122222111112122011111111011011111111111101110011011111111110111010a11010111111111011011a1011001111111111110a111000111011111111111101011111011
0111120110101212111121021200020220111111111111111011111111110111111011011110111011111a11111101111111110111a1010111101112201202b220221121111011122112111111101111
1101001211001120211011221220111220111001101111101001111111111111011110111110111111110a01011001010011110101a1111101101112122200b011222221212112120001211111011011
0100211011211222220222211101221022110011111111011111011111101101111111101110111111101a11111111011011111101a1011011100010001211b212011101122120011101111111111111
1111122210202012211200222110012012010101011111111111111111111111111111111101111111100a11111101100111101111a1011101111111102121a111122201220011221212011111111111
0111111212112202220111011112012110010111111110011111011111011111111011111111101111011a01110111111111111111a1011111101112121212a211202121220201102221111111110011
1011112201221010220022211222100220111100011011111111100011111101110100101111010111000a11101101111011011110a1111111011112021022a111212101221110100212011010111110
1110222222122012112022102111112220111111110110111001011100111111110111101111111111111a10010101110111010101a0111101111110101210b002110121220211121200111111111110
aaaaabbaaaabbaaaabbaaabaabbbbabaaaaaaaaaaaaaaaaaaaaaaaaaaaaaaaaaaaaaaaaaaaaaaaaaaaaaaa10011100111101110101a1011011111112102220b121222221101002021200101111111101
1101110102111222122221021112011111111011111111111111111110001111101110111111011111100101011111110111111111a0111110101100211011b122211211122220121112211111111111
1101210211111220211211111110211111111001101011111111111101111111001101011100111011111011111111101111101111a1101100101112222112a210111002102220222221110111110100
1111211211221200111122111002012211111011111101111101001111111101110111011111011111100001111011111110111111a1010100111111121211b110111112100102122201201101111111
0110111211110111122202201102122221111111111011110110111101111011011111111111101111110111011101111110110011a1111011011012212200a020200102020212201202010001011011
1201020200122222201212120122002100011111111111110001001101011111001111111111111011111111111111111011111011a1011111110112020120a122202012212212101112111101111001
2211020222220010012202222120201121000010111101010111111101110101111101110110100011111101001110110011111202b0011022111222122110b122220102211011011212111111111111
1102222022202002221212221222221210111101111011111111101111111111101101111101011111110111011101110101111011b1210121101002120200b222200022021222210210111110111100
1121101212102200102121211122010110111111111111111011011111111111001111111101111111111100111001011010011220a0122212202121212220b012020122102200111111111111111111
1010212222122022212221212222221122111111011111111111111101111001011111111100011111001111111101111010111022b1110012212120012212a122112221202121222222210111101111
aaaabbbbbaabbbababbab2221221222212101111101110010100101111111111111111111111111111011100101111101111011111b1101211121210112212b122202010122011022222011111111111
21202222102221102122b2120020212112011111111100010101101111101011111001101011111111111111100101110111111212b1111221222221222212b110220212220112022011201111111110
02022220200122210212b0222212222212111111111111101111101101111111111111110110111111101111111101111101111020b2212201221000222022b221212212220111112210211101011110
21202222121202210022b2222212222122111011111101011110111101011111110010011101011111101111110100110001011222b0112110012212212002a022212211102222101110211111110101
12222210011022210001b1101211221111011111111111111001111101111111011111111111111111110110111011011101111210a0011222011020220222b210222221000222202222100111111001
22202111202221201011a0110111001010111101010111111010111111011111111111101101111001101111111110111011111011b1100022220212220012b120122122210221210201111100010111
21122121102202212201b0111100221111111111111111110111011111111111111110101001011111110111110111110111111012b1220111212210122212b002012200012221211221000111111101
20020020112001212021a0111001210111111111110010110101101111111101011110111111111111101111010111111011101210b2221110210110122212b020212012222221211120200101110110
12121222011011221120b2210201211101110101111110111110111111011111111110111111111111111111111101110011111211b2202111120222021112b122121112112212211122111101001111
00021101102202212122b2122212021011111011110111110101111101110111101110111110111111011011010111111011110012b1221221222122220222a222220120120111201021111111011100
11120021122201111121b112021122011011111111111111111101111101111101aabaaaabbbababbbbaababaaabbaabaaaaaaabbbb2120110220211202221b222212221120011120222111111111110
22001102220112100202a211210112100011111011111110001110111111111011a02122211221222011110222202122210111111202010012212110021122b201222221211221121002111111110001
11102122022102100120a111122100101111111110011010101111110011011001a12201220222210222102012120011211110100220122211001000022202b222122110202222222222201101011101
12112001220112110220a221111020111011111111101111111111010111011110a22112120121120022221022211202210101022212000212222221122121a022011111111111111111111110010111
12012200110111111211b122102221111101011111011111111111101111111010a01221200212022102221122012221111111011221112200202211111212a222220111011010111011110011111011
22110211220221212121b102212200111111111111111110111111101001101011a12220222221220110211200211112011100102112121110100121111110a111210111111111110111001101101101
12211012212222222122a112022111111111111111111011010011110111111011a10112220221101211222220202000211111100100211022022100101120a120121010111100101011100111111011
20122021122010201210a211212201111001011111111011111111111000111111a22020221002112202221122022021222111202221221222222220022200b022112011100001011100111101101110
11211110011100110122b111021112101110111011110111110111110111111111a02112202212121222220102222200011022022222201221122222021112b112120111111111101101111111101110
10111111122221102110a222212201111111111111111111111111001101111111a22122011222220022121212211102221101112121221122121222221222a201022011111101110101111100111101
00011010011211210021a212212200101111111011101100111011001011011111a12210112021201212212210122121202010211011220002202200102022b012122110101111111110000111101111
12021102201022102222a222022222001101011101111011101111111001111110a21111011101011021121111111212122200020222222201122112210222b111212001111111111111110111111111
20100121222211210212a010221210111111011111010111011111101011101111a21112222112101100212121021112002121222222111222202102210222b220121011111111111001011111111011
10202211122110001221b021201211111111101011111111111101011111011110a12210022221110111211110221112111122011022212222211210222222a211120111101111110111101111111000
11110212112120022222a202122000011010110110111110111111011111111101a02221102122000220110222022121220010200222211222221012222211b102112111111010011111111111111111
11111011111110010111a111100111110100011011111101011111110111111111a02221221111111200112211221221220202222220022020002211222211a001110110100111111111111111111111
11111111011111111111a110111111011101101110101111010101111111111110a10220221122001021221221212112011201121011001012211220202011b110111011111111101001101111111101
11101111110111111111a101111100111111111111111111011111111111111111a21102120120101021210120021111022221112110210221222112202221a110101101110110111111110111111110
11111000111111101101a001111011101011111111111111111011110111001110a21021112111211102111120222011111020211212221111112211212022b011111001111011101101011111101011
01110111111101111110a011111011110111011111111101111110111111111011a11112121210012021222102102110101001112220101112021211101122a111101111110111111111011011111111
10111001110101111011a011011111000111101111111001111001111101101101a20211122111020100211112212022000212221120012212120002111220a101011001101111101101011111110011
11111111101100011111a111111010101111111111111111111001111111111101a20111222122211221120212221111012110121210111200021200120110a110011111111011011111100111111111
11111111000111111100a000101110010111011010111011101100111111101101a22222012202211021110121201101220212120221020222112121201212a111111101011100101011111110111110
11110111111110111011a101111011110110111111111110111101001011110101a11210202122022001212222012120101212211121211211012212202212a011111111111111111101111111111111
10111101110010010111a011110100111111111011011010010101111011111111a11211222120222120121121021121212010111102121221220220221111b111111111111110011111110010111010
11111010111111111101a110111101111111111111110111101100111111101110a10021122021122022022212202121001021001212222212112022212221a110111011111110100101011111111111
11010101011111001111a110000111110011011101011101110111110111111111a11120000112111002110122022212101212121020110002112101202222a011010111111111111101111111010111
11101110111101110110a110001101110111101111111111010111101010011001a21210102002121012212200222202221101222001211210122010111001b111111101110111111111110111111100
11001101110110111111a111111110110110001011011010110011101111100011a20020221011120012210221021121102201012021110212001111112121b010101111101111111110111110111111
11111111100011111001a011011111111011101011000111011010111101110111a22122220110112210112010122100000200122011221001210121221101b111111011111111111111011011111111
11101111010111111111a011111100111111111111111110111101101101101101a11111101111010011001011111111002112212112111121101211201210a101111101111111011110111100111110
11110110111111111111a111111111111101111111111111111101100111111110a11101110111111010111101011111110210102221211021121222210111a111101111111001011101111111111110
10011111100111110011a111111110111111001111011111111111111010111111a10110100111111110010101011111111200102110112122110211022021b001111000111111111011010111011011
10111110111110111111a011110100111111101111111110101111110011100111a00101111111110111111101010111120122220122222100212121021112a101011010011111111010111111111011
10111111111111111101a011111011110111101111010111111010111101111111a11111111110010100111111011001001210021210022221010112211012b110111111011111111111111111111011
10110111001111111111a111111110011111010010101111001011100111101111a11111111111110111111110111111122122220102120121122121201212a011111111011111110111111111111111
11010111111111111111a101111101111111111111110101110111111111101111a01111111111111000011011111100111222020111222202220100112211a011111101111001111111111101111111
11111111111110111001a101101111010010110010100111110110101111101111a10111110111111111100011100111111111000111111102101101102101b220211222220010101111010111110111
11111110011111101100a111111010111110111001111111011111111111101111a11111110011110111001101111111111110111110011111120011122101b012021112011202100111101110101111
01011111100101100111a110011111110111101111111111011111111111011111a11111111101111110000110000111110111111111111122211021212210b201211221111011111111111111101110
01111110111111111011a111000111111111111110111111001111111111111011a01011101111111100111110010111011111110001111101020022101101a221202122012220111001011001110100
11101110111111101111a011111101110011101111111111110011011111111110a11011111010110111110111111111110011011101111110102212110110b022211002111211111101011110011110
00110110111110110111a111011111111111110100111111100011111110111011a10110111101111001111111010111011111111111111122220202220111b202021211222110111111111111110111
11100101111111111111a111111100001101100101111111011111111111111100a01110111010111110111101111111011011011010111110021101102022b220111121212221111111001001011111
11111011110111111110a110101011010101110110011111001111101111011101a11111111111111111011101111110110011111010011101011122022220b011101110201212110111110101111111
10101111011110011100a111111101110111110110111111101110100101111111a10111111010111111111111111101100111011101111102001210110111b111222210212002101111111111111000
11111011110001011111a111100111111111111110111110111011111111111100a11011111101111101111111010111101111111011010101112221212002a001212110002020110111011111111101
01011111111111011111a111110111011111111001101111111011011111011110a11111011000110111011011101111111101101111101121202121212211b012121201201110110111011111010111
11111111111111101011a011111111111111111111111111111001111000111011a01111111111110111110111001110111110001110011100211022012212b012212112211120111011011111111111
11010111100110111111a111111111111011101111111111110100110101110111a11111111111110101101101111110111111111110110021101002011212a122120202111021111111110111111011
aaaaaaaaaaaaaaaaaaaaa101111101110112121122112122001122211211022110a10111110011111110110110110111101101011011011111121102111201b112100210210222101111011101111110
110111111111111111011111011111111212212121112122212102102212021110a11111100001001111111011111110101011111001101112101112011212b221021122212121011110111111111111
111110111101111101111101111111011122212212212111102022201201121010a11111001110101011111011111011101110111111011121220120120011b001221212101121011101101101111111
010111101110101010111110111111101121011212121112202221111122211101a10101111110101111101101101111111011011110110011200121212211b212211211121220111111111111111111
111101111111011110101100111111111011022201200110011022112211220111a00011110111101110111101111101110011111111011112100211122120b221221212010121110110111101001111
111111100100110110110111110111111100022212210201102012210121201111a11101100111111111110011101111111010111101111021210212111222a111201111121222110101110110110101
111110111110111111001111101101110221000020222122112202221100120111a11111111010111101110110111101111111000001011112012210220221b010222022212211110111111111011111
101111101011000100011111111001100202020012120212221100102022202011a11111111111111011110111111111111111111111101001221211122211b211101220212211110111111110111111
111110111101111101111100010011111012222121210121122121021211112011a11111111010110111110011111111111011110011011121111220210212b200122211221211000111010111111111
101111111110101111101111111111111201211102122012211210000200101101a11100111110111110011111011111110111111111001121111222112202b221121011212211111001110110101111
110111111111010011011011111010111211011100010222211122221102111111a00111011011111011111111101011111101101000111001102201200012b010222012202110101101101111100111
111111011101110111010111110111101022212020102111121122122120112101a10111111100110011101011110011111111010111110121221222210212b120020212110100111101011101011111
011001110011110100101101100111111011010101011211211221112122011111a01111100011001111101111111111111111111111111102210001120111b200101021112212011011110101101011
111111111011111111111110111110101201101022121211111012211022210101a11111011111110100101111111111101111111111011110120122221200b121101222122220011011111111011111
111111111001011111111111111011111112112211121221121010111221200011a11011111100101111110011111011111111111110011110021221201222b212201211110222111011011111011111
111111101111010111111011110101111002111221202112012000011121122111a10100111011111010111101111111111110011111101121000112121102b102120222212211111100110101111101
110101110110010111111101001111011212201122111212110022121212212111a10111110110111101101101101101111111111011011022002101012111b211121122100201111111111100111111
111110111111010010111100101101111121211021002112102022012222000111a11110111110110100111111111101011111111010011101111110101101a111101111011111111110001111111111
111100111111111111111111111111011121122221211121112121120202202111a10111111111111111111000110110110101100101011110110101111011a101111010011111111111101111111101
011001111110110111011111111111111101112222221221220102010021000101a10111001101110011111111010011111011111110111010111110111101a011000101111100111111111111111110
000111110111110111111011101111001011121112201122110121221221101111a11111111111110111111110111111111111110111111110111111111111a111011111111111111011111101100111
111111110111100111011101110101101010110022121121121111010112221011a10011110111110111111111110011111011101111111111111111111111a101011111101110111111111110111001
111111111111011011111011111100111101001121122201022021212212022101a11101110111111011001111101111111111011111111111111111101101a110111110111111101111111111101011
111111111100011101111111101011101121111110112100000101122012121111a10111111111011111111011011111111011111111011111111111110110a101111110011111111111011100111111
011110111011100110011111110011101111120211222122120212221211211111a11111111101100111100101101011101011110111111111111101110111a000111111111111101111011101011111
111101111110111011110111011111111000211221021000011212110001212001a11011111111111111011111111111111110111011111111111101111011a111011111111101001011001111111011
111011111011011111001101110111101222221220022120010210112121002111a01011111101111001111111100101011111011111101011111111111111a111101011001111101111111110111010
001101101111010101011111011010111101022111122012222210010111011011a11100111111111111111111111111111111101101101111101101111011a010101111010011111110010111110111
001001111111011011111011111011111112022111221222001012200221221111a11010111111111111101011110111110111110111011101110111111010a110100110111010110111111111110011
111100111001110111011011111111111100201110202111221211121001122011a00111111011111011111101011111110011101010011111111111111110a101111011111101111010011111110111
