(3, 18)
(124, 3)
(53, 20)
(123, 2)
(37, 79)
(97, 42)
(120, 107)
(100, 78)
(2, 63)
(94, 18)
111011111111001110111111a0110110a110111111111011111011111010100111110111110111111011101111111111110011111110011111100011011111110110a101110111111111110111111111
111111111111110010110010a1101101a011111111011111011011111010111101111011101111111111111111011101111111001111101111101111101111111011a111101111111011111111101111
111111111011111100110111a1111111a010111111011001011101111100011011110111101110111001110110111011111110101101111111111101110101111111a110111101010111111111011011
110101001011111111111111a1011011a111110111111011111111111111101111011111011001111110111111111011111111010111111101111100110011111101a011111111000111011110111111
111000101111110110111111a1101111a110110111000111001110101110010111111111101111111102221112121111212220120120222001100111111110011110a111101111011011111111111001
101010111001110011110111a1011111a110111111111111111111000101110111111111001111111110221221010210202001021011122211111100111011011111a111100101111100111111111111
100110111111101111111010a1100111a111111111001111111101101111110111111111110111110110210212221122010112110211222121000110110100011111a111111111111111010110111110
100101101011101111000111a1101111a111001111101101111111011111111111110111111010111112022211121112121012121121211021001111111110010101a111110011110011101111110111
111101001110110111011111a0011000a111011111111111011101111011111011011111111111101102011101101121111121111102221201111101111111110111a011110110111110011110011101
111111101111111111111111a1101101a111111011111111111010111011111111111111111111111110211211221111212001111221022021111110110110111111a110111010111011111111010011
100011001010100110011111a0011110a111110110111101110101111111110101111111111111111110202110211221210211110001112011110011011111110111a111111101111111101100111111
011111100101111011111110a1111111a011111001111111111111111111111111110101011110111011112121212211122002210221221201101101011011101101a100010111101011010101100111
111011100110111011011001a1111110a110100111110110111100100101111001011010111110011112212020212122212102101012111221110110111110111111a111111101111011111101111111
111111111111101001101111a1010000a101111111101110111101011111111111111111110111111011201221102211202111100111111201111011111010111111a110111201011220221222200112
111111101101111110111111a1111111a101101101011111101011111111110111101011111111111110122121001022121210112011122111111111011010101111a111102110211122121201020220
101111110011111110011111a1111111a111011111011101111111111110000111111010122212121202200222222221222021120122111211111001111110110111a111111101012201111212111211
111011111111111011011011a1111110a111111111110111110001111111111111111101121220102021222112221020212022021021110021011101101001110010a110112021112212022000121111
111101111111010010110000a1111111a111111111110111011111111111111100000110110012100212112122102222222021221201211121101111110110111010a001101200110111202110210112
111011111101110111111011a0110110a011111110011101111111101010100111111010111211112002222222002122001222121002121120110110111111111111a011122021120121222012112121
101111111101110111111110a0111110a111011111111110111111000100110011001111111112021222020222010202112002012102212120011111111111111111a111111011022100110022121111
111010111011111111111110a1111101aaaaaaaaaaaaaaaaaaaaaaaaaaaaaaaaaaaaaaaaabbbabbbbbbbbbbbbbabbbabbbbabbbbbbbaaabbbaaaaaaaaaaaaaaaaaaaa111120211201222212211211202
111111111111111010111111a111111111101011111110111110111111101110111011111121211112012212022122222020212011211121211110101111111111110011012112111111202101002102
111010111001011011111110a111010111111011111111110111111111011111111110101212001211212222222202220122201100012111011000101111101110011111111120222212022121211120
111011111111101000011111a111101010111111111111111011111111111111101100111111102122002221202220121222221112200221011101111000011110000011102221220202112100202112
110111110101111111111111a111110111111111111110111111111111111111101111111101022202111222220220200200212212111122110111111011111111101111102122101212110202121222
010101011111011101111111a111010111111011110111111011101111110010011111111012101101220202122122222220220111211111111111111111011111111101121120000222221102221220
101111111011111101111011a111110011011010010111111110111111111111111111111021212110121222020200210221012011222101111111100110111101011011021011211112121022010111
110011111010111110011111a111010111101111111011111111111111011111100111111112122121121212020022202222202122002220220112011111111011111101010122221222221221211221
111101110111111111101100a110111011111000111101110110111111111011111110010022112211020202122022222202002202211122221222211111011111011101111210212112011011120102
011001111110110111111011a110111110111111110101111111111100011111111101101022222021221012222220012020210212020020111022211101111111111100111120102012220202202110
101101110111111111010001a111110111111111111111110101111111101111110101111021111121212212222220220022221212211121012211211111111111101011122101011221012121011021
011110111101011110010010a101111011111101011111101111011011111011111011111211222212222222222000222122002220012221020122101111111101110001100121112200021122202111
111011100111111101111011a111011111111000010101010111111111011111111011111222010221122211222212221222122222020220110110111110111100011110102210221110122220212012
010100111110010111011111a100111001111110111111101111011101110111101111111122010020102010220022222022212202212212201221200111111001001110010202112201111222211012
111011001111110111010101a100111111111111011111001111111011111011001011011211021022101002120222021220112110120121102022200011001101011111020012202122010211020121
111111101101111101111000a011011101011101111100111111110110101111111111111211121211122201122222202011220102101111212011111111101110111110121220211021112210122221
111111110100110110110111a011111011011100111111011100110110001111111101001221121021211210021222122022122202010001120211201111011111110101021122122112122002112221
000111110110111111101111a111111001110111111111111100011110111111111011110221211212100221102221021221220211220022222212211001111110100111111102102122112220210212
111111111011111011110111a101011010010101111111110111011111111111111111111212212110212102122212122222220121211211210122111111111111111111111001120100121011120200
011011110111111011111111a011010111111101101111111100111111110111101101111012112102110111200022202021121012211212220222211011110101111011021002121110221101211211
100010000010111101111111a1011101110010111110011111011101110101011111101002022211121120000212202012212221210022102222222111101100111111111221abaabbbbbbbabaaabbab
011011011111111111111111a1011111111111101111111101110101011101111111101112222221011112210222202120211102111202100201112101111111000111111201a2120221111100102022
011111101111111111110110a1111111011011011110110101001111101111110011110111222121111212211122222210222002212021021121122111010101010111011221a2102111122212202102
110111111110011111111111a1111101111111101101001011111111101101010111111100001111112110001222201210112201122122010220001111111111011111101100a1111110110111111111
101100111101110111111110a0011111110110011010111111111111011111111011110111212201211222221022212211220020201020021222102011111110111011111011a1111111111111111111
111111101111111100011001a1111101101010100101101010111101101101111011101111111111101111111012011012011000110222122112210110010101111110011110a1011111111111111111
101011111011100111111111a1101011111011110111111110100010111100111111011101101111111111111110121220111221110121211122202011111010110111111101a1110110100001110111
111110101101111101111111a1011111100000111111101111011111111110011111011111111111001101111222121220122112221220220202222100110111011011101111a1011110111111111111
011011111111111100110011a1111111111101111111101111111011111111110111111111111011111001111222211201221221020222012222212111111111111101111111a1111111110011101111
111001111111111111111101a1011101111111111101111101111001100111110110111110111101111111111201111120010122102110221022221121210100120112212122a2201110211101110110
101110111111101101011101a1111110111111101011001111011110001111011100001111100001001111111111210002102220121201111100002202221102212122010221a0212101211110110011
110111111011101011101101a1111111111111111111111111111110011001010110101111111010111111001111222210122111022122201112021202212211210121221222b2121112111101011100
111111111111111111111111a1011011101111110111010111111011111001111011111111111111011111011222102112211110012121211121220012221201111111112111a0121112011000101110
111111111011111110111011a1001111111100111101001111011111010111101110110111011010010110111211101111011202020221212122111111001212212221112212b1210122111101011111
101111010110111011111111a1011111011111101111111111010111111111111101111111101111110111011211221201010211002211111111111011020222111221210221b1221000201111111101
111111101111110110111101a1011111111111111111101111110122012202102020110111121212012110010212002011002011111211121012101202101111112121112111a2010221011111111111
011111111100111011111111a1111111111111111111100100111002220001122112121111111121201211111121211111112222110120200211222112011002122202220100b1122100110011111110
001011111111111000111011a0001111011110101111010111110111112211021001111202121121211011111010111101110111101111111110010211121121202122220222a0222202010111101111
011110001001101000101111a1110111011110111110111110110012212022111110210102220021212211111111110111111101101010111011110222211210201212021222b2222111211011111111
101111100101110100111011a1111111111111111101101111111110210102210011222112212101112111111111011101111111111111111111111012202122022222112002a1120102211111011011
101011111111110111110110a111110011111000aaaaaaaaaaaaaababbbaaaaababaaabbabaabaabbbbbaaaaaaaaaaaaaaaaaaaaaaaaaaaaaaaaaaabbabbbaaaabaabbbaabbbb2111102111111110110
101111111101111011111011a111111101011111a10100011110011122221210012220102202121222221011111110101100011111111111110111112221220011021111210221221201010111110101
110111111111111111011111a111011101101011a01111110001000210212112221112111221201121120100011101011111110110110111011110120220100100222212211211112222211111111111
111011110011101101111110a110100111111101a11110111122201102022200222211221220212121201110111111110111111111111111111110112021110202102122001121111120211111001111
111001011001010110100101a011111111101011a10101111102112121202002022202022201120011221111111011101111010111010101111101112112122011102110202221121121010110011111
111111111111110010101011a111111111111111a111011111120221221bbbbbbbaaababbbbabbaababbaaaaaaaaaaaaaaaaaaaaaaaaaaaaaaaaaaaabbaaabbbaabaaaaaababbbaababaaaaaaaaaaaaa
111101111001110110111111a111111011010111a101010011121222022b2212222012022121222222101111111110011101110111111011111111111122101020222112101002222111211111011110
111111111111111111110111a110111111111011a111111111221222212a0110020222012202212002121011111111101011101011111011110101102111121121100120212021011101201111111111
111111110111011100011111a100101000111111a111011011212100220b0222201222212112012211121111111111111011111111111111111110101112110121001112022221012021010110011111
011111011110111111111101a111111111111100a111101111101221222b2222222220010122111222101010111101101111101111011111111110111210220202211220221220221210101001111111
110111101111110001110111a111101101111111a110110111120220112b0020020202200122122212101111011011111111111111111101111111102222121112102112222211122122210111001111
111111111100001111000011a100111011011010a110111111222122021a2121102221002012210021221111110111110101011011011011111111120202212101220200210010010101200110101111
011011110111110100101111a111110111011111a011010110022222222b2011102212122211200222100110111010111111110100110101111110111202122121021102000110222110210111111110
011111111110101110011111a111101110110101a100010011022201222b2002021220222122222112221111111101110111111011011111010101110211210011122010211222110112210101111111
111111111111110000011111a111111011111110a011111100021202211b2012200222222110120212001110011110100100111111111111011101121202011120020111222211021120111111111110
011001110101111111101001a100101111111111a110011000111121002b2221012202220222102222221111111111111111101111101110111111111021111211202112211022012122211111110111
010110011101001111101111a111111010010111a011101111112002222a0220022122101220220112211011011010111111111001111111111110122211222102121211022121120101211111111000
110111111100111111111111a101110111101010a111111110111122121b2222020222222122211010120111111111111110111011111111101111121121112122210221110221221012101101111011
111111110100111011111111a100111010111100a101111010210220222b0122202220222222011000020110011111110011111111111111011111101212121122011211200102122212210111111111
111111111111111110111111a111101111001111a110110101111100222b2212220220222122222221111111111011101011111001111111010111111110101111101101111101101111101110111110
aaaaaaaaaaaaaaaaaaaaaaaaa111011011110100a111111100110222022b1122220221122210222002021111111110111111111111101111111111111111101011011110101001011111111001111111
1111110111110111111110111011111111110110a011011111112102021b1221212122122122121221111111110111111111111111011111111111100111111101111111111111110111101101101111
1100111111111011111111102101102221222111b202211211212222022b0212222220122220200220220111111111111111011111101110111110011110001111101011110011100011110101111111
1111011101101110011101112122221112222112a221202212202200222b2020212122221010200201121111111111110011111110011101110111110001110110111111111110101110111111111111
0010100111110111111101111111211012010200b211001200220122222b2202022011112112222221111111010001111100111111100111111110111101001011111111111111111011111111111111
1111111101111111101111111110112210102010a201012211222201011b0101012200012012222211110001001111111101111111100111011111111111101111111111111111010110101111011010
1011111010101011101111110000021020201201b221112111221222012a1022102012222111202011111010110101111111011101111111101111011111111101111101101110111010100101111110
1011110111000000101111111010022212212111b112202000010222221b2210022210011200211211111101110001111101101111111111101111110110011101111111111001011111100110111100
1000111111111101111111102102222202201020a220011222222012211a1121211200122212102201101111111111111101111111111101111011111110110011101111111011111110001111011110
1111110111111110100011110100202112212221b100121122022221211b0112201211202211122011111111010011111101011101111111001100101110110110101111110110010000101011111111
1011101111111101111101011121120202012201a111220112202210012b1001220122211100021110111001111111101111111011100011101101101111111110111111111111100111100011100111
1111111111110111111100111210221222012012a122212001222002101a0112021221121121212110101111111111101011111110001111111011111000110111111111111011101111111100111111
1111000011110111101111112000111221110000a212200221212111201b0210111121122211021011111000110110111111100011111111101111110011011101111111111111111111111111111111
1111011111111110011110110011112212212102a201221211102211100a1101111111111110000010101111101111111110110111111111111001111011010101011110111111111111110010111111
1110111110111101111111100200121021212110b121121012021211111a0001100011011101111111110100110111111111001111110110111010111110111111101110111111111011110111111110
1001100111111101100110111100101012211212a001010120211111111a1111010001101111111011110111111110001111011111101111011111010101011111101101101111111110111111111010
0001111111111101111111111222111111121222b210122111112010111a0111111011101101101101011011110111101111111011011111011111111111110111110111110011110011111111011111
1111110111011111111111112121001010011022a022221201212211001a1111111100011111010101111111010110110111111111110011111011011101011101100010111101111010110111111111
0101110101111011101110101122001120221211b112011110111210111a1010111110110001010000101011101111011101101011111110111110111111101111111111110100111011101101111111
1101110111111111111001001201202121202211a221222102202000101a1101111111111111111101111101111111111011001111111110100111110111111111011101110111111110111110011111
aaaaaaaaaaaaaaaaaaaaaaaaabaaabbbbabaabaab210201022222211110a1111101111111111111111111111011111111101100111111100110110110111100111011111101101110011110111111000
01111011111110100111111122222120210222121021221221212001110a1111001010011101111011001110111111011111001111111011110111101010011100110111111011101111111111111111
10111110111010111111111102221212112011110211211212222111101a1011011111111111111111101110110101111110111011111101101101111001010111101111011110101111101011111001
11111110100111111011011122201022221112222102102012222211111a0110111110101111111101111111111101111111111111111010000111011111111111110111111111111111111100111110
11111100111111111110011122221101001202222010111101212000111a1111001111111111111110111101111011101111110110111110111111011101011101011111110011111111101111111111
10111100111111111011101102212212122202111121010202212211111a0101111111111110101001101110111100010111110100111011101110111101111111001111101110110011111111110101
11111111110111101111111111012021110110101201200121202011011a0001111111111111110111111111111011111110111111011111001101110111111100111011111111011111111111111111
11101111101111011001111111012122112110020212012020201111111a1011110111111111111111011111111111111111001111111011101110111111011111011101011111111101111110011101
11111111011110110111111121011102212022021220022111221000111a1110111001110110010111111101001111111111011111111011111111111111101101110110101111111110111101100101
11101011110111111101011111222022122202021111111211122101111a1011010011011111101110111011111101000111011011111100111111111111111111111111111101001011110111111111
11111111111111111111111122101112111012222211101221221110101a0101111101110011111111110111011111111101110111111111110111000111011111101111011101011111101111111101
10111011101011101111110120211101012211011111000110220011110a0111001101011111111101101110101010110111011010111011111111100101010000011110111111111111010110111111
11111101011100010010110111111100010110101010111111101001111a1111000111011111111011111111101101111111111111011111110111111010011011111110011111011011111111101111
11111101111001101011111111111111011111001110111011110100111a1111101101100110110111111111111011011110111110111101110010011111111111111110110010110011101111111111
11011100101011111111111111011101110110111111111111110110111a0111111111111011111101101110011101011111111000111111111111111111111111111010111111101111111111111111
11011111111111111111111011101011011111110111111111111011010a0110011111011011111111100111111111101001111111011110111001101101101100111001001111111111111111111110
00101100111101111111011111111101111110101111100011111101101a1111111111111111101111101111111011110111110111110100011111111101000101111100111111101101111110111110
11111110011111101111011111111111111111111111111101111110100a0111110011111110111111111111110111101111011101111111111101111111111011011110110100111111011101111101
01010110110010011110000111011101101010111011111010111101111a0111111101111111101110111111111101110110100111111010111111111101101110101011100110111100111101111011
11111101011111011011111001101111111110001110101111110110111a0111011111111111111111110011111101111010111111110111111111001111111000011111111110110101111010110110
