(12, 18)
(156, 113)
(115, 61)
(86, 119)
(30, 113)
(120, 93)
(44, 51)
(29, 23)
(87, 77)
(144, 18)
11111111111111111111111111111010101111011101011111111111101110111110111100111011a10110111111111a110101110111111111001111010111100110110a111a01101111111111111111
11111111111101111111110111011111101111111001111111111001111111001111111111111110a00111110110110a011100011101111010101010111111010110111a110a01111111101110111111
11111111111011111111111010111111101101111111011101101010011011010100111111101110a01010111011111a111011110111111101111111111111111111111a011a11111111110101111111
00011110111101110011011111011111101111011111001011111111110111111110111111101111a10111011111111a111001101011110101110111111111110101201b222b21221210202002001211
11111010111001111011011111111011111111111111011111110110011111111001111010111111a01100110110101a110111111100010111111011111110111210210b010a11221022021211121021
11110111110111111110110100111111001111101100111111110111110111111111111111111111a01011111111010a001111101010010101111110111011111202010b220b21122221221212221201
10101111111111111101001011011110011011110010111011111101111100110011011111110010a01011111010111a111001011101101101011011111111101222122b111b10211210120001122101
01111110111011110111111111111000111101111111100111011011110111110110111110101101a01110111011111a110101100111111011111111111111110122101a222a12110112102020210211
10111111110111211122212221101220020222101222101111101100111111111110110001111111a11111111111111a101011111010111111011111101111010121020a222b00011121012111012221
11110101111111021012211000012221012101201022111101111111111111101011111101111111a11111111110110a010111011100101011110111010101111212222b221a22121222012111012121
10111111101111220022221102102111121200200102011010101101110111111001011011110111a11011111111010a111101111011011111110111111111111120022b212a02102222220112021201
11011111111111112111111011221011010221111100101111011111110011111011111011101011a11101110110111a111101111111101111011011011111111110221a121b21021112211010202111
00100110101111122110101111210001222211122100111110011011110011111111111111111001a11110101011111a111111111101110110011101101111101021120b122b12021211202211112101
00101111101111021212211122202112110221111122110101011111111111110111111111110110a11111111111111a001000011010111011111111111111011212110a122a22111112101022121211
10011111111111022122111222210110211111122202101111111111111011111111110110111011a11001111110011a111111111111110101110011101111011121112b212b00122021101211222111
11101111110111222201201221122022022220221001111111011110111101111101000111111111a01110101001011a111001101011111011101001111111111110011a221b20102102121120122120
11111001000101222212111001012110101002122101111011110111101011100110111111011100a10111110111011a101111111011111010110111111110111110211b222b12101012200002001001
01101110111111201110221111000210212122011011101111110100110101011111011111111111a11111111011101a111101010110111111111111111110111121121a220a12101222010122120021
11111111111111020011112202122202212202021100011111110011111101111100111111011111a10100011111111a101100111011011110111011111011101222121b020b22222012220121210101
01111111111111121011102122112201100112212222110011111111101111101111111011110011a11110111111011a111011001111111111111101011111101212122b122b11201011101202022111
01111011101001210022122112202212110012211102011110100101111111011111111111111111a11100110011110a111111111110111110111101111111110222212b222a12111012222012112211
11111111110111201111210110200101221022022020101111111110101110100101011011011110a10011111011101a110001111111011111111111101101111011121b021a12011120220102001211
10111110100111012212111020221120121011211121110111011001001111010001111010110111a00111111111101a011110010111111110011111111011011210211a011a02211121112111001121
11111111101011122211002010220111211111021101100111111111111101010111111111111110a00111111111111a111111111011111011100111010101011110210b111a00121100211211111121
10100111111111101212111012220210220011111222111111111111110111111111111110111111a11110111110111a111001001110111111111110101111111212102b221b20110221122122121111
11111011101101121100112202211021111020201022001110111100110110001001101001101011a01111100111111a010111101111111110110101111101001011120b101a11200211101121221221
11111111111011220211011101011112011112122222111111011101100101110111111101110111a11100010111110a011111001111111011110111110101011102102b110b11202222111112202111
aaaaaaaaaaaaaaabbabaabbbabbbaabbbabbabbbaaaaaaaaaaaaaaaaaaaaaaaaaaaaaaaaaaaaaaaaa11111111111110a111111101111111110100111111010110122210a212a12021221221112221210
01111110111001121221022202011021222211111210101111111111111111011011110111111111011110111110110a111111111111101111111101101111111122211a201b21111122111222221201
11101111011111212220112211120222112122101222111111111111011101111010110001011111011111111111100a111100111111101010011100101111011201101a201a02022222202212212211
11111111111111212111020011021021201212012212111011100111111001011001111110111110111101011111110a111111011101111110111111111110011212112a021a12111212110120011021
01111111110111122202211001212212200221222221101110001110111110111111110110111101111111110111110a101101101010100111110111111111101000202b121a10220111211101211221
11101111111111121211202201221021222112222121111111011111111111101101101111001111111111111101011a111111110111110111111011101100111221111a222a22110111221212112121
11110011110110200222120201022122021212212111111101011111101111111111111011111111111011111101111a101110111111011011110111111111101011111a111a00111111111101111111
11111100111111222122121020211102101201221012100101111110110111111010111111111111011011101101111a110001110011111111111111011111110010101a011a10111111011111011110
01101111110111121212110121122221212012210211101111111101110100001011100111111110010111111111101a011111011111101110110101010111000111110a111a11110001111111111010
10111111001111002121101120011221212001222021212011021212111111111100001111101110110110111110111a111001010001110101111101111111111110110a111a11111111111111111111
01111101111111100202121012020011222221021112200222111112100111011111111101011111110001111011111a110011011101101111101111111110111111111a101a11111111011111111111
11111111111111111011100010111222211220022012222221100210221001011111111010110001111111111111111a111011111111011111111001111111001001111a111a11111111111111111011
11011010110010111111111011111112120101012102121121122221210111111011110111110111101111111111101a110111110110011000110101111111111011110a101a11111111111101111111
aaaaaaaaaaaaaaaaaaaaaaaaaaaaaaaaaaabbaba1021201002222110101110111111111110100111111111110110011a011111110111011111101111000001111011011a111a10111111111111101111
011110101110111101101111110112221222211a1111221211111211022101100010111101111110111101111010011a111100111110101011111101111111110111111a111a01110110011111111111
001110110101101000111101111101122211212b2110112222121210122011011101100111111011101111110111111a111001000101111100111111111100110111110a111a10111111101111111111
011100101101110011111111110111201100211b2211112111112120222111111111111111011101110111011101111a111011011011111100110111111111111011010a110a10111100111110111101
111111011101111110111111101011212211121a2112110122201202210111111011011101111101111111111001011a111011011110101110111111111111110111111a011a10110011110100011011
101010111101011101111111111012122222102b2201122212012211212111110100111101101110111101111011111a101111111101110111111101011111111111111a010a11111101111111110010
011101101101101111110000111111200211222b1021211111210122012111101110011111010011110111101111111a010111200220112012102122202210202211111a010a01001111110111001111
101001011111111011111110101100001210110a1122111121220022121111111110111111111000110111111011111a111110012110221202020221212121221211011a101a11100111110111101011
111101100111111111101011111012002212211a1201202011200102010111111011111010011111010110111101101a111110221102100002012101022110012210110a010a01011111111101111111
010101111001111111111001111011212222111a2221012211221200201110001111111111110110111110111111011a111010220221122101112111221221021110111a111a01011011111111111111
101111111111100110110100111112101000110b0212202222221102222110101110111111111111001110111111010a111111201110221202112001212121202211111a101a01111011111110111110
111011101111111111111101101111200211221a0120222112200102201110011010111111111111011111110101111a100101211211010221211022101101120211001a110a11110111101001111111
111101111111101110111111101102222021110b2121112201111111011111111111111111101111101101101011111a111021022110011011122111121112210011111a110a01011111110110011111
101101111111011101110110111111121122112b2221212111021011212110111011101110111011110111111111011a111111110110121220220122221010021211111a110a11111011110011111101
011011101111111100100111100110022212222a1212001101212121211011101111101011011011101101100111111a101101121220022122202210212220210211111a111a11111101101101111111
111111111110111111111111010112120200102b0122222000010012212111111011111111001111111011011101111a011121212111111102112222012200122211111a111a11111101110011101000
101011011011010111111111111101002000201b1220021212212022102111011111111111101111001111100101011a101101022112111122102122210120221111111a111a10111011111111111111
111011101101101111111111111111010012002a0102001101121221120111101111010101011011101101111001011a110112202221112102220011220222221111111a001a11110010011001111011
001101111111111111110111110100202102112b1222022101122012110101011011101111110111110111111110111a111122022211021022122112111002011101111a110a01111011111111111011
111101111011110111010101111111202102112b1211212101212112100111111111011011111111101111111111111a001112121121200122000221010222221111111a111a11110111110111101110
001101101101110111001111110010200222100a2211120102121212222111111111111111111011101000101111110aaaaabbaaaaaaaabaaaabbbaabaaabbbaaaaaaaaa110a11111011111111111111
110111111110110111111111111012210112122b212012210201012112011111100111111011101111110111101101111111111211102202122200110200202020111111111a11101111111111111111
111111111111111111011100011112102122110b011120120111211222001100111111110011220022220211222121212010022210222200211212100202121212111111111a11010110101111101101
111111111110100101111111011112021112121a222012212120002120111101111010111122111212022101110211122122221112112201211011111111221222011101001a10101111111111111111
011111111111010001001011111111122202221b021122111211110221111111011110012120122102110101021100121011222121012111222220212202001211111111111a11010101110111111010
110111101110111111000001111101012200021b011120011100022112011110111111101222221212110202202102122211212010111122000112122210120210100001111a11110101011101011110
111111110110111110111110010111111111110a101011111010110111111010011100111202212122121022122211122001111120121011201111111111021202111011111a01111111111111111001
111010111101111111101111111111101111111a101111011101001111111101111011110021100011011022211210112111122010222110212022001221010110011111100a11111011111111111111
101111111011101111011111111111111101001a101111110111101011111111101111101112211122210220100210020221112102120222110001122102101221111111100a10101111110111111111
010011011111101111011111111110110111001a111111111111111111111001110111112010201201212212122121011122221121111112221200111202212212110111111a11101010110111101011
011111110101111101111111101101111111110a111110111111111111010110111100011022012112212220221211221021201020220011110212121112210221110111110a11111110110111111111
111111111111111111101011111111111110111a111110100111110111110101111111011211222100211100202220221221220200122012111222221102200112011111000a11111111110111111010
111101111101011111011111111111011001111a011011111111110011011110001101111121220001222102021122112111012122112011202210011211212221111110111a11111111101111100101
111101111110111111111001111100010111101a111111111111111110110111111110111220112212102021100011111202000101121001212111222110020222101111010a11110111011100111011
111111111111101110110111111101111111110a011001011100011111101110111111111110202010222201202022101101212222202222222212120122012100111110111a11111101111011101111
011011111110011011011111111011111111011a111111011110101111011101111111011122021010002121020222100121221011211111112210212221000220000111111a10111111111011111110
111111011010111111110111111001110111011a011111111110101111101110111111111200000221221120100202222121121111110111011011111110111111111110011a11101111111011011101
001011111111010011111111110011110111111a000111101001111111111011010111111102001100202222001100112011100101111011000111110011111111101111111a11110011111101111111
011111010111111011001111101101111110010a111100110110011111111110111101011020110122120110202121121202021111111011022121222211121121212121011a10011111101011001111
001100111111111111011101011111101111111a101011101100011101110111110010102200221022020212002211221010121112101212121221110100201211000011011a01110110011111101111
111110111101111101111110110111100111111aaaaaaaaaaaaaaaaaaaaaaaaaaaaaaaaababbaaabbbaababbbbabbbabbababaaaababaaabaaaababbbaaabbababbbbbaaaaaa11101111111110111111
0011111101111111111101111111111111111111111110101001110111111111000001010000201112000212220210120121121110022222001212200012221000200121110111111011111100111101
0011001001011101111110111111100011011011111111110110111111111111111111112210121120000101211220022201111111002012102211112122012011210221010111111111111111111111
1111111011011100000111111011111101111011110010101011111011110111110100002100200122100121120111222102120111112212120000221212200012222221110111111111111111111100
1101111101111111111111110110111111111111111100110111111110111111110111110110111121112220101201121022220012201100220112212210210121011001111110101100111111111111
0111111111011111101111111110011111111011011100111010111101101111110011100112001210112111110211121222101112121221212222010221011121020210111101111111111110111111
1111110111110101111111111111010110110111110111011010111001111101111111110111210122121011100002111212121111111020121111121212022101221111111001011111101101111111
1101111101011111111111111110011111110111111111011110011111100111101111112022112101201111201222200212221101011012110111021120211102121211111111110011111111111111
0010100111111111111110011111011101111110111111101100111111111100111111111220121022102110210201222110111001221110111121021201111020112221111011111011111111111111
1110111111010110110111000110011011011110101110111111100110110111111110011101221002110112101121110221211012102022112122121121221202202201111111011110111110001001
1111011100111110001100101111100111011100001111111111111111011111001111012221111021122001212121102212211110212012121011210011211022210221111010111010110110011110
1111111111111111111111000111111111011111100111111111111111100110011111111001011101112221222212210022101112001200112210221221212112221011101111111110111011100000
1011110100110111110111110011111111111110111111111111111111001111010001111111111110111111111011101101111112222221112022120222121200201121111111101110011111001110
1111111111110111011111101111111111001111111111111010001011011111101101011101111011101111111111111111111112120111102101102122111221112120110100111111111010110101
1001011111010111011111100110111111111110101111111110111001111100111110111111011111111111111111111100110111211001101210112211121121211121011111111010011110101011
1111110011001011110101111111111010111110111011011101110100111100110101001001110111111101101110111110111112112221120211222020001210211101111011111111111101111111
1111101110101110001111011111111110111001101101110101111101110100111011011111111011011111000111101011111002121021012222110021212122211101111111111111101011011111
0111000111111111111111111110110100101101001011111111100111111111110001101111111110000111100111111110011110100211102021212021202111221221010110111110011011111100
1111111101111111100210021212220120111020122211110111111001100111111101111111101111111111111111111111011112121021221222012020221112112221111111111111111101111111
1111111011010111112002aabaaababbabbabaaabbbbaaaaaaaaaaaaaaaaaaaaaaaaaaaaaaaaaaaaaaaaaaaaaaaaaaaaaaaaaaa111210020112112211010000120110210111101111001011111100111
1111111011101010101201a0210221211010011022122111111111111111111000111111011010111111111111111110111101a111121121121110112122221222121011111111111111111101111111
1111111111011112120212b2202221101022212111120111111111111101000111111111111110100111101111101111111111a010021220000211202122100112112221001111111111110111111101
1011110101110112100121a2121122112120111021220101101111011111011011111001111111111110110111001111111111a111221021221112221221112212101211111111111111111011110101
0111111011011112101101b2200202002112021111211111111110010111111111111011111111111011101101111101011010a111211122110122101002221021212120111111110011011111001110
1111111111111101110022a2110202222212121202112101111110111111111101111112222021201102222010022112210221a101202212222121221220120210112121101011111101110101111111
1011111111100112010111b2121221101121220222001110111110111111111111111111010120222221121210221212122220a111211221120012101200111211221221111010001111010111111111
1111110111111111112101b0222202221112002121111101101111001011101111011012120111222012110211022021121011a112120211201212120111120112201111111101101111110101110111
1100110111111111111022b0022120211012211102011011111111101001111111011111202121220010121210200222211121a000221112211022112111112101212121110110111011101110111110
1010110111111011210221a2122002111102121210200111111111011000010100110112011202122111201222112202210021a111101111111111011101101001110001011111111111101101011111
1111111101111111121011a1022100112222011120021000111111111111111001111112210022111222012210221112220000a111101110101111111101111111011010111111111101111011111011
0101110111111010100211b1212122021212122201112111111111111111011011111101211012222220111121212120111211a111010111111011111111011111001011111101101011111110001101
1101110111010011001122b0222122202122220211200111111111101011111111111011202112121102221202121021100221a111111111011011111101111110011001111101111111111011110011
1101111110110112202112b1101211222121212112112111011110010111111101101112121022221211120222201222222211a111111011110000100111111110111101111101111111011010100011
1101110011111111210112a0021221121021212122001111111011001100111101101111211222202221020011010011202211a111111110111111011101111111101010111111101011101100111111
1111111000011100222111b0111200002011120222120111111111101101111111110110210111121111112002111202201101a110111111001111111110111101111101111111010111111111011111
1001011110111100201120a1211222101221120110011111101111111101111111111011012222101221222210201212011221a001101111111101011101111100011110111111111111011110011111
0010101101111101010101a0211220012221220122221011011101110111111110101102222122211200121120211022012021a111110111110111111000100101110111101100011101011111101101
1101111110010111112222b2012222112212122212020001011011111111111101111110001012201101101222111001021111a011111010111111011011110011111101101110000111111111111111
0111011111011110220221b0102221121221111122221011111111111111001111110112222121212120212022002211211120a010110111111011111110111011111100101111011100010110011111
1111100101010100012122a0021210200210222212021111111111101110100110110112202220012101121210021210222201a010101111011011111111011101100111111111111011111110101101
