(19, 88)
(132, 96)
(53, 20)
(123, 2)
(37, 79)
(97, 42)
(120, 107)
(100, 78)
(2, 63)
(94, 18)
12220122210212222112211101011111111111100111022022011100202222111220022111111111a1011010011110111100111011001101111111110111111101111101111110111101101001111101
22202211012210222120201001011001111011111122112211212111110201111111002111111111a1011111110111011101110110101111110111111000000101111011100101110111111010101100
01121211210121001201011111111001111111111122202120212212221120011200012201111111a1010111101011111110110101101111101111011111110110111111011101011111010111110111
22122110101212120021211111111101111111111022222112020112200101121222002211011111a1110010110110011011011111110111010111111111111011111111111111011111111111011111
11001122211212011001011111111111111110111102022212012202112122001201222101111111a1101011111111111111111111110111011110101111111101111011111111110101111100111111
02000110211212121122001111101101111010111120200112112202110101220112120111111110a1000111111011111111111111111110111001101101110101101111111111111101110011111111
02212120011122221212011000111111110110111101101210110121112100112212211111110110a0111111011110110111101011111111111111111111111110101011110011111101111110101111
11212220212101120211201111110011101101011122212022220221222112212021001211111110a1110011011011100111111111101110110111110010101111011101111110011111111100100111
12201211222112102121111100011111011011011102221111112201211212220210120111111111a0011001011010111111111111110100110011111111111111111001101111111110101110111101
10021222121021211011101111001111011111111122011220202221200212010120111111110111a1111110111111110101111111111110101111111011111110111111111001111111110111111110
10121222121111211202100011111011111110111121211012201010220221122112100011011111a1001101101111100111111011111111101101101011111111111101001111100111101111111110
abbbbbaabbaaaaaababaaaaaaaaaaaaaaaaaaaaaaaaaaaabaabbbabbbbaaa1202012212100011001a1111101111100111011111110111110111110011110111111110011111011111111011101110011
112112221100122011220101111111010110001100101111200212222220b1221000201210110011a0111111110111111011011111001011101111111111111111111111111111010010010111111111
122211222112111221210111111111111111110111221222001201001210a1100211110001111111a1101111110011111011111111111101111110111011110111011101110101111111111111000111
121210222212201112220111111111111101112112120120212222212210b2220210101211101111a1101010011101111111110011111011110111110110101101111111111001110111111111110011
111221110120201211121111111110100101012201201222202010122220b2212120200100110011a101010101001010111aaaaaaaaaaaaaaaaaaaaaaaaaaaaaaaaaaaaaaaaaaaaaaaaaaaaaaaaaaaaa
011112211122211122111111011111111110111201222221112220222212b2202221120111110110a110111111111101111a011111111011111010111111111111111111111101110111100111111110
012220001020221122222111001111100101111010221222221121021212b0200222121111101101a111111111100111111a110010111110011011100110111111110111110111111111111111101100
211221022111120100212001111111011111111202202201022122212012b1220201121211011011a111101101001001111a111110111001001111111111111111111011011111101101101111111100
212122222221212211222111111111111111101112022102220202222222b2022222221111000111a111111111011011121b121011122011221112111210120011111011110101111111111111111110
211121221121221212112101011111111101012210222021220202210022b2222222022211111101a110111011111111112b022220002212111012021222022111110110101001010110011110111001
210222121202101111111011011111011100101110222021022222222201b2220100122211110100a011011111111011101a101121022222222110111202111111111111111110101110011111100011
211121221122201102022101011111000111111202210222001122120122a2021222201210111111a001111111111111110a220220011210020102121211221111111011111101111110001111111111
122002221211221012012011011111110111111111211220022202121222b2221121111111111111a111111111111101111b012120211110001200111212101111111101111111110110101111111011
212111112001222111012111110111111101112211112101102201011212a1101001111111011111a111110011111010122b212121122211202022211002100101101111010100001110110111110111
221012221212121211112110010111111111110211110202212202202012a1222022002121011001a111110001111111102b212211222102211222112202110110111111001111111111011111011111
220112010001202211121111101110111111111121112212010221022022b2222222000211110110a110111101001111001b210211122012120122201221201011111111101011111100111011111011
121211212122020212111111111011111111112101022020222022102202b1212222220121110101a000111111111111110a211102222012022122220111111111111110111111111111111111111111
012121222221120111201111111111111111012212102121022211122221a2020120022021011101a111110110111111111a211212220211212211221220120111111101011101111111101101011111
110101011110010010110111011111111111012011220102201210022222b1222212221221111111a111111111111110012a222120021001021112111112000111111110111011101111101111110001
011111011110111111110110110111001111111112212201210010020222b1202122221221110111a110111101101011111b101122212222112122222020000001010110111001111011111111111110
011110111011111101011001111110101011102201102001222211021221babbababaaabbaaaaaaaa111111111110011120b112102211202101110101022100001111101111110111111011111111011
111111111110011101011001111111111000112212220220112120222020102222221122211111111011011111111101121a122121110222201221101201110111111111111111001111011111001001
111111101101111011110011111111111011112200222112222120212210221222121022101011011111011111100101000a102202211100112121121212002110111010111111111111111011110101
011111101011110110101111101101101110111110221121020202220201022122222110201101111110101101111101121b221212022201020112210012011111100101110111011101101111110111
111101101101111111100101111010110111112120110120220220222202222222201220211101111110001111011110102a221201111200202220121112212111101111110111001101111111111111
110111110111111111111011111111001111001122102012221202200200122122221222211101111111110000111111101a212121211012121112101022111101000111010111110111111101101101
111001101111111111110111110111101110011110101022022212222202212022222022211001001101111111111111102b020101110010212210202121222111111111111011110111111111111001
000111111110101111111110111011101111102022112222212122222122200221222222201111111111001111011010112a020222122212121221210222111110111100010111101111111011111110
100011011111101101101011101111011110102201202122202122222210220222020212011110111011111101101111111b110000220212121122112122010111111111111111011101101101110111
011111111101101011110111111011111111111020200120222102222121222222001021012122112212100021122121122b222111122021211122101212101101101010111111111111101111111111
111111010011110111111101111111001111111212220121220012210200220121220120212221122122212210112221102a222202112010112222220211210111111111111011111110000111111101
011011111111111011111111111111111110110211122122112202122202222120222101012122222121211121112110112a021211121112212021012010112111111111010011001111101111111110
011011111011100101111001111111111111111111012100112201100222222202111112221222022112021202101212120b121102011220110000211101122101110111011010111011111011111011
110011111110111101111001111110101110111111122110122221121012221110010201222221212101101222201121121b122110101210121202010120121110101111111111111111011111010100
101111111011111110111101111000111111110011121220111210211012112202020211211211122001111021002112202b202022000011112102222122111101111111111010111101001111110110
101001011111001111011111111100111111011111122021002102020220111121021101211022201122212111212122012b201021101111121211011202101111111001111111111111111111111111
111101110111011011101110011111101111111111120111020011220211212212112102211012001212200002020121122b220221212012112201120101122111110101111101111111111101110110
001111111011111011100110110111111110011111022122202111221210122110022202222022122111022102211222201b121110222210211220220212121111111111101010100011100101111111
111111111111111100101010100111111111111110120110122102120221012122210101212221110222222101212102121b020111111010111111101010011000011101011011011010111110100011
001110110111111111010101111111110101111011122100221211212122100200111202212111102212100122222221102b220110010011110111111111101110111011111110111111111111111110
111111110011111110110111111101111111110101111222021002221012220020222112010220110022010120210112120a211111111001111110101111110110101111101011110111111010111111
111111110111011101011111100111011011111101112110120111101011122001220012020001202021122121100222211b120111111111111111101100101110111110010111100111111111111111
111111111011101001111100010110111101111101111211220211201112022211012212212011211111011211012001012b111011111110010101111101011101111101111111101111101110101110
101100101111101111111101110110011110111101120111021110121112221212212210212221000112122120200012212b121111110111111111111111101111111111111110111111101101100011
111101111111111011101111111011111110111111111111111001001111101101011011021201211122121220101222022b020111110101111101110100111111011101111101101111111101111111
111111111111111011111011111111101110111100111111011111111011101011110111101110201012012212221111112a12101011111111111001aaaaaaaaaaaaaaaaaaaaaaaaaaaaaaaaaaaaaaaa
110111101111110111101111101012101200201121000111111001011110110111111001102222220200121011210120201a12111111111110111011a001111110111111101111010101111011111001
110111101101111011111210210111202211222101102222121111001101111111111100220212122222122021022120112b22111101111001101111a111111010001111101110111100011111110111
110111111110111101112220112121222012111211120101000111111111001111101011212121121122202120222012112a12110110101110110111a110110011101010111111111111101101111110
111111111111111110112221101121022202011222222121211010111011101011101111211100222102121220012122210b12111111111100111001a111110110111011000111110111111111010001
011110110001001101112011002212221021111211011110021111111111011011111111222002111101111111110020021b12111111111111111111a011111111111101111101011101111111101011
110111101001111111112211121112221101222202201220210111111011110111110011010211022002010111201100112a10111101010111011111a110111011111011110111111101100111111011
101111111110010101111221102112111101012212111111111111111111111011101111222112211211210211112122202b10111110111111100010a110111111111111011100110111111111111110
111110110111101110101120111222010210212211102201221011111111111011011111012121011201101001001000212b12111101111111110110a011110101111111110110011111111000111011
101110011111111011001212020121022211011022222211221111011111111110111100022211201211012121200222122b10101111111110010111a101101111111111110001111111110111011111
111111111001110111012212201210112222221112111122211101101011101111101111211212110112111112211220112a21111111111111111111a111100011011100110101111011111111111111
110111111111111010101221122012221022201210212000020001111011011010111111212212112022101021001121212b20110111011011111111a111111111110011010111111101011111111111
011110011011011111111001101122212011122112211122210111011111111101111111112210120112121221100022012a01101111111111111111a011011111101011011110101111111110111101
111011111100011111011112122111121110212001220120211111111111101111111101202221122120201201010220111a12000111010111111111a111111101111100111101110111011111110111
111111011110110101112112212101211221021202101021121111111111111011010111111111101110101111101011111a11111011101110111110a111001111101101011010111111010011111111
111011111111100110110222121211121221221211122102111010011011111011111111010111100111111111010111101a01100110011100111111a111110111011110111111011111111111101011
011110111111111001111011101221101022222222202022010111101111000110111111111111110111111110110110111a10001110111101111110a101011111111110010111000101111011011111
111011110111111011112211200202101212202111222112101000101000101101101111101011110111111111110111101a10110111011011111010a101111011101111111111111111011101111111
111111000101101111111212112202210112020102022212110111011011111110111010111111101011111111111111101a01101010000110011111a101111110110100101111110111101101111111
aaaaaaaaaaaaaaaaaaaaabbaaabbbabbbbbabbbaababababaaaaaaaaaaaaaaaaaaaaaaaaaaaaaaaaaaaaaaaaaaaaaaaaaaaa01111011011111011111a101111111111001111111111011111101101111
011001111111111101112022221200022211112210212221201111111111011110010111110101011110110111010111011111111110111110101101a111101111111110101101111111011101101111
101010111101110111001211100010022102121120121211221111111111111111001111111111100110111111101101001111011011111111111011a111110011111101001111111011111111111111
111001110111011111111211121121101101101120122102111111111111011010001111111111110111111111101111110111111101111101110011a101110101110111110110111110110011111110
111101111011111010000102212220101212122111122112121111111101011110111001010101101111111111111110101111111111010101111101a111111100111110111111101111111111101101
101111110111111111111221012202222001221210002211121100011111111011100111011111011111111011101111001111011101111111111101a011111010011001110101110111111101011110
111101001111010111110210221011012221212011220221120111010011111011111110101011111111001111111011111110111000111101111110a110110111111111111001011111101111010111
111001110111001001112110220212000020211200122222221101111011111110110111111101111111110101101111111111111111011111111111a111111001000011111101111111011010101111
110111101101010001101211212111121110212201212210211111101111000111111111000001111101111110011111101110011101111111111111a111111111011101011001011110111110011111
111111111111110111111212210112211212201212211121121111111001111011110111111011111111110111111110010111111101011101010110a011111011110111010111000101110011111111
110101110111101001012112202221012212120111221102101111101101111101011100111111111111111011111111111101010011111111111111a110111111011110111111111001111111010111
011110011011011111011101121222021122010112111011100011101111111111111011011111011101111110111111111111010001100100101111a111111111110111111111101011110001011111
111111200101011121222122212202001210111111111101111111111011111111011101100111111111101101110111111101111111011011011111a111100111111101100011111111100101101001
100110221012221002110211202012011111110110101111010101011110010111100011011111101111010111111110111111111110111111101111a110011110101101110111111111100111110111
101011100011201221121122210100021111111111111111101011101111111111011110110011010100011101110011111110101111111111111111a111011110111111110100101111011011101110
101110222002200211022011121111200021111101011111101111111111011011111111111111111111111001001111110111011110111110110111a110101111111111111111111101111011111111
101111102210111001222210122110210211001111111111111111111110011111011001101011010010000101111111111101111111101111111111a111111111101101101011011111111001111100
011010200120121222110001012110121121111101111111111111111101001100001101111001111011110110111111011110001101111111001101a111101010011110111011111111101010101111
011112121121121022112011222212211211011011111101010110111010111011111111111111110010111101111111011111101111110110111110a101110111111111010111111111111111010111
101001121111102012222002002210111020110111011111110101110111110111000011111101111111101110111111111111111101111111011111a111111101111111011111111111111111101111
010011120100110212210122122112121211111111111111111110111011011011111111101101101001111111111111110010100111011111111010a101111110110011111110110110111101111111
aaaaabbbbababbbabbbbaababbaabbbabbaaaaaaaaaaaaaaaaaaaaaaaaaaaaaaaaaaaaaaaaaaaaaaaaaaaaaaaaaaaaaaaaaaaaaaaaaaaaaaaaaaaaaaa111111011111111101011111111100110111111
1111121112221111122102011211112211111011111110011011111101010110111010011100111111101111011110111111111111100111110011011111011111011111101110110111110110100111
1111121110002210212012122121212201211101011010010001011101011101111111010110011001110011111111111111111011111000011011111110111100111111101110100101011111110011
aaaaaabaaaabaabbbbbbabbbaabababbaabaaaaaaaaaaaaaaaaaaaaaaaaaaaaaaaaaaaaaaaaaaaaaa1001011111101100010100011111111111101110010011001111111101011111111111011111101
11111111001120121111020210102000222111011111011111011101111110101110011111110010a0111111011111101101110111101111001111111001101110011110111111101111111111111110
01101221120112220101211121212212212011111111011110101111101111011111011111101111a1111111111111111111110110110011111100111111111111111111011111111111011111111100
11110200001112121210112212112020220101111100111110110111110101000111111111000011a1111110101111111011101101111111111100011011101101110111111111111100100001111011
11000222212211102212112201210221211011111011011011101011001111011111101111110101a1111111110111101001111101110101111111011111011110010011111101001010111111111111
11011020111021211212121120221110122111111111111111011111111111111111111101111011a1101101111010111111111110010111111011111011011101110011101011111011001110011111
10111212221121022022211012102002201111111011110111111110010110111101110111111110a1111111111111011111111101111111111111111110111110111011111110110111111111001000
11011002211101110212111122212121111100111101111111110101111111111111110111011111a1110001111111111010101111101111111101111011101011110110100011111110111101111111
11010111002122211101011122121011220111111111111011111101111101111111111111011011a1101111111111111110100111111011111111110101111111101101100110100111111111111001
11111220221221210011112212212121112111111111111101101001111010111101111111111110a1111111111010111111111111111111111111111111101111110001001110111111101111111110
10110221101221100220100112222221101101001101111111111111111110010111101100111111a1111111111100111111111111011111011101111011011111011111111111010100110111111010
11111112121211120221111010011111212101111011111011111101111111111010100111101111a0111111111101100111111011011101101110111111111011101111010111111111111111011010
11101112221101110221201101020011210110001111000100111111101011111111111111101101a0111101111001111111100111110100111011110111101111001101111101111011111010111010
10111002202011122110221210221211122110111010110110101110111111011110111100111011a1111111001101101111011110110111011001101111111111111110101010011011111110111100
11110211110212101011221022101121100001011111101101000011001101111111111101011011a0010111111001111110111111101111100011011111011111110101011111001101111011111111
01111100210121211210101022221220221111111101111111101111011011111111111010110110a1110110111110111111110111111110101010111101111111110011001110100111101101110011
11101211002222110212212022022111011111111110101111111111111111111111111011011011a0101011100111111111111001111111110101111111011011111111111111011110100111110111
01111101122202122000202201202112201010101111011111011110111011111101111111111111a0111011111011110111111111111111111110111001111001101110011000111110110101110110
11101111011100110111111111111011111011110111111111111110001011111011011101101101a1111011101110111101111010011001111001111110101111101111101101111101111111011111
01101111001001001101110110011111011101101011111010111101111111101011011011101110a1110011111111111101101111111101000110111111111011101110101101011111010101110111
011101110010011010111011111101011101010111011111111110101111aaaaaaaaaaaaaaaaaaaaa1101011111101011101111011111111000111100101111111111101101111100111111111011000
