(4, 2)
(96, 62)
(71, 42)
(76, 95)
(65, 30)
(87, 106)
(144, 87)
(87, 61)
(30, 32)
(109, 32)
011010111100101111101010001101111011111010101011111101111111110111110111101111111011111111011111111110101011100111111011a111111111111001110111111011111001000110
111111111111101111111101111111010111011110111111111011111110110110110111011111110111111101101101010011110111001110110101a110111111100111011011111011111111110011
111111000101011111111111111111111111110111100111111110111111101111111101111100111111111111111111110111011111100111111111a101111111011101111aaaaaaaaaaaaaaaaaaaaa
110111111110101111001111111111101110111111011111100011111111101101111101111111110111001110100110111111110111111111111111a111011111100101111a11111001111111111111
110111110011000101101011110011111111101101101111111111011111111111011110111110110111110111011101110101110011010110111100a111111111110111111a11011111111111110111
111111111011111101110111111011011111111111101111101001111011010111001111111101110110111111110111110110001111111111110111a100111110111101111a11111010110000111100
110101101101111111111111001111111111111111110110111111111111101111111111011111111111111111101011111111011111110111111111a110101111110111101a11111101111110011011
101011011011101111101111110111011010011001110101001011101011110111111111110111111101101110111101101110101110111101111011a111111011111111011a11101110101111110111
111111111111111111011001100101111011111111111111101111111111111110110111001111111110111100100001111110011101111011111111a111111100011110111a11011101111111111011
101111111111011111110111111111101010111111111110111111111101111100111111110111111111110111011100111111111111111111011110a101011101001111110a11111110011101101011
001110111111001101111100111110110100101111111111111010011111101011111011111101111111101100111111111100101010011111111011a101111110011100011a11100100011111111110
111101111111101011111001011111111111111111011011111011111111011110100110001101111111111011000111111111111111111111110111a101011011101111111a11111100111111111001
110111100111110100111111111001111011011111101011111111000111111111110111011111101111011011111111111011111101011111100111a101111111100101011a01111111111110111111
010111111101011111111111111111101111001110111111100101011111111111110111101111101101011111111110101101111111110011011100a111111110111111011a11111111111011111110
001111110111111011011111111111011110111100110110111111111010111011101011110010110110111110111101111110101111111011110100a010111001111111111a11110110011101110111
111010100010101111111001101111111111101110011011111222020212122021222110202011211111111011111111101111111110001011110110a001111111111111110a01111111101011111100
101111101101111011011110110100111101111010010111002012111022221222211021102111210011111111111110111101111111111111111101a001111111111111111a10001111111101111111
111110111101111112201102111212222111101222212111011220100222101221120211212022101111001111011102112112011221210212110221a112101111110101101a11110111110110011010
011111111101111221012202212112011221011112122111111210222021112221210221022212021100011111110102011002121011111210211202b221111111001111010a11111111101111111111
111111111101111121121011211220202101211021210011111102202120121221000002022012001111111111110112112112022201001201220111b201100011101011111a10011001101110101111
111110110111111220120001022102222120201110222001111112011201011111110100211102110111101011111122010121220120020122121022b101111010101101111a10111111111001111111
111111111110111222110111221010112221121122122101112212212121212112212210222012201011111111111022010121112222122111112221b011111101111001111a01111111001101011111
111110011101110222201111121002221010101111110011001221220110121122022222220211201011111111111112222202120122021112211122a111111101111111101a11101111111110111111
111111111011110120001111021110212202211121112111111122121122002010021212221221021011111101011121111220112122111111112122a211001111001100101a10010101110110111111
11111111111101122221abaaabaabababbbabaabaabbaaaaaababbabbbbaaababaabaaabaabbaabbaaaaaaaaaaaaaaaabbbaabaaabaabbaabaabbaaba011010111111010010a11011101010000010111
11111111100111121011a2112210112022120121220210111122012111111110102111122220222111111101111111112211111201102121222121200222110101111111011a11100100111111101111
01111001111101102111b2010112201111000122100211101020022110100102112112210010210011111111111101201010212211211122210222201201001111110111110a11101110111101111011
11111111110111101222b1101212212122111011120111110012111222122110211022022202121221212210111111101002210111221122101201012112111100101111111a11101111101111110111
11111101010100011122a0121112211110102112212200010120221021222222212212212222211210021211111111102102121212221212201121022201111111011111111a01111011111011011011
01110011110111120112a1211110012222210222112101101120121122112202002220222121122221202111111111212011210222102022011220211212111011011100111a01111111111101101110
11111110001111111202b1221201012121121211200111111112122202211120110211220221222201221011111111112012022100211222221202212122111111101111101a11101110111011011110
11111111111101102212a1022212211221122110022201100122122200120002102221212121112102221211011111220022220220221111020212210211111001101101101a11111111101101111111
01111111011111102212a1202202111212220201202211111112121022212222222002122222222211200110111110122211212122021012221121001201110101111001011a11101101111111111111
01101111001111100200b0122122121101221211221111011010122011212222102011222212221211000011110111112000012022101111101220201221011111011011011a10111111011011111110
10001111111010001000b1101211022110010222202211110112022121200212202022211222002222121100100110210221202010001211220122010111110111111110011a11111111111101111101
10101011101111111012a2120120201221220001102121101121121222022222202221200202102020221211101111221010022222212210000212212000110111111111011a11111111110111111111
11111000111011021220a0212221120101121211212021111111111120210212022212022121200212101211111111001120222211220111012101011221111011101111011a11011111111110110011
11111111101111020000a0110221122121101222011011111121210222220010111212220211002212221111111110102111022111001011122001201221011010111111111a11110111111010111011
11111111011110022011b2212012102222222222121221110111002022020200202201120122201221222111110111201211122112222022122101101112111111110101001a11111111111110111101
11101011110010102202b1222100022121122211011101101121222220021202122200120222222200012211101111212020112102210201221212212121011011111111011a10111111111110101101
10110111111110110122a2212222102100222010111211011122121122222021021220222012212011210111011011221002112020112122201212110222111001111001011a11010111110100111111
11111111011111001100b0012012122222212001011111111102202121021212012212202001222122112101111111212120222101112211212112010022111001111010010a01110100111011111011
10111101111111111211a2221222221102002122112111011111111202200102222202220222222121110001011011001121202212211212222221212121011011111111111a11111011110101100011
11111010110011011210b0222011222121022020221111011111221200012222222222100221022121101100111111012112222021111220001212021002111110011111011a10101010001111111011
11111110111111101211a1210112200212121020020211111001011020220121012220210122222211021211101011012112001212102002202110012221101111001001110a10111111001011100101
11110101111001112111a2222012222120121122111111100011111022021110112221102012211220101211111111211121221112201010102100122210111011111111111a10111110111011111111
10111111101110021211a0111000121102002002102011101111110122001010222220011220100122111120022122220000201211212112201212212112110110001111111a11111110111111101111
11101111001101101101a0011101110101011101111011100011111111100020201111011022201212222102102212201111001111111111101110111111111101111101101a11100111011011111111
11101111101111111111a1110111111111101110111101111101110122012022212221120222021222120221011012112122111111110010111111111111101110111101111a11000111111011111101
11111011111110111111a1011100111111100110111111010111110121021221112202002100020201021211211121222012221101011111110101111111111110111111111a10100101111110111111
11111101010111111101a1111101111111100110111110011101101121220022211211001211222121122011211022210202221111111101111111000011011111111111010a11111101111111101111
11111111111111001111a1010110111110100110111001110101111100202220110202002202112202112212021222121101200101111110111111111110111101111111101a11111110111111011110
01111110011111111111a1111110101111101110111011101111111020200111202122102220022212220012112021220101111001111110111110011111110110101111011a11110111111111111111
11110111111111111111a1110011000011111111110111111011111102111122200010211221122202222012112122121211121110101111110111101011011101101111011a11111011011011101101
01111101100111110111a1111110111010011111111011010111100021220122212202010022021022022201222110111202011010111111111001111101110111111011111a11101110111101111111
10111101111111111011a1101111111111111111010111110111111121002010110221222021212122212001210211201001121011111111111011111111011111011111111a11111110111111011111
11101111111111111110a1010111111101110111010111111011101021000021120221102022221202002221202202211212221110011111111101110111111111011111101a10101111111110111111
11011100111111111111a1111001111110010111111101111111101111111110011111110022102122002222221010212220111111110111111000101111100101110011110a10111011111010111101
11011111110111011111a1111001110111111010111111011110111110101011100000112021001022212222012001012120111111110011000011011100011111110111100a11110100111101111111
10111111111111111101a1110111011011111110011111111110110111111111111011102211011211012200100222222111220111101111111001101111111011101111111a11111110110011110111
11101110111111011111a1111111101111110101111111110001000110111011001101112110122121110021120021112222201111001101001111011011000101110110110a11101010101111011001
10011110111111111111a1101001101111111111110111111101111011011111100110111001011121220220222111222121211111111101111111101011110101110101110a01101011111110111101
11110111110100111111a1011101111111110111101111100110111111011111111111112122120122212212112121121020120111101111111100111111101111011111101a11011011100011011111
10101111100111111110a1111111111111111111111011111101101110111011110110110001120112102212211111112110211011100111111000101100011110110010011a11100100010111110101
aaaaaaaaaaaaaaaaaaaaa1011111111111111011011011011111111100111111111111011101210020202102212211211210100111111111110110111011110111111101101a10110110111111111111
0011111001111111011111111110111011111110101111111111001111111111111111011210210221111101101202102111021001111111111111111101001100110101011a11111110111111111111
1101111100111010101110110111111110111110011111110110110111011111110110100002100021220102210222211202221110111011110111110110111111111111011a11111100011010111101
0011111110111111110111111111110011111111101111001111111111011110111011112002010012022121102021222022201101111011011111011111101101111010101a11111011111011111001
1110111100100111111100101111111010111001011011111111011001111111111111112222221211011221111211010202121101111101001111101110110101011111111a11111111101100101110
1111111011111100011100101010111111111111111101010011001111011111111111012212222220122202212101112221121110011111111011011101011110111101111a11101001111110111111
1111100101110011111110111010111111111111101111111111010111001111011011112111111100212200002112220122211001011011111101111111111110001111111a01111100101111011111
1101111111111111111010111110111101011110101011101110111111110101111101111121002210001110212122122012211011111110111011011111111111110011101a11011011101010110111
0101010110111111110110011011111111110111110111100011011111111110111111101022202121221222221211120012221011110111101111111110111111212122111a12200212101220212211
1101101111100111111111100111111100111101011101011110000111110100111001111221122201220221122022020111211110101111111011111111111110222201112a22022020021211211021
0111100100101010011101011011000111101111010111111111011011110101011110111202210012112221221101121021111011011011101111111111111100220112101b10220202112010222221
1011001111111010111101111111111111111111110111011111101101111111111011011011111211020022010212121200101111111110110111100000111111220100022a22122202011101202101
1111111110110011110111111111111111111111101111101111011011101111111111111011111101110110111111010111011111001000111011110111101101011221122a22122220021112120021
1111110111111111111101111100111111111111111111111101111111110101111101011111111001111111110110101101111011111111111111111011111100222111222b01220221010202100100
1111111111110101111111011110101101111011101111111111000011111111111111111111111101101111000101011001111111010101111010111111111111122221021b20121211111011221021
1111110010111111111011000111011111101111110111111111101011110101111101111011011111111111110110111101111110111111111101000111101012101111112a10201011121200111001
1111111111111111111110110111111011010100111111100111010111111022112010121011211112011011102001101011011100110111110011111011111111102021122b10122211012001212111
1111111110111111111111111111111111111100111111011110111010111011111111212102012001122222212111111011100111101111111111111111001101222001112a20112211110021010211
1111111101110111101011111100011010111110011111111100111111011211121211101120202112121102000111111111111111111111111010111010111111110211112bbbaaaabaabbbbabbbbba
1101111111101101111010111001110011111011111011101101111111111001121201122210200221121121221010101111111111011010111101111111010111001102111122220220122201120101
aaaaaaaaaaaaaaaaaaaaaaaaaaaaaaaaaaaaaaaaaaaaaaaaaaaaaaaaaaaaabbbbabaaaabbbbbbbbaabbaaababaaaaaaaaaaaaaaaaaaaaaaaaaaaaaaaaaaaaaaaababbaaabaabbbbaaabbababaabbbbba
1111110111111110110111101111111111111111111110111111111011111022121221211121210202212001222110110100110101111111101110110101100112111111112011111022012111112111
1010011110011001011111110011111111110110011111111111011110111222111002222212011101212222201010111110111111111111111011100111111100011100212110001122221120102001
0111111111111100011110000111110011111111111111110001001111011121112101221121022112222000020111111011001111110110101110111101111102201222110111110022010021012221
1111111111010111111101111101101111011111111111111110010011101120222210210222222202101221211011111100010011111000111110111111111112001002100211011202210211222121
1111111111110111111100111110011111111011101111111100111111101012210001102211121211122112021011111111111011111110111111111011111110111112211121011021202221202221
1111111011101111011111111111011111111111010111011111111011111222221020212212120112210012122100101011011111111010111101111111110100221210110011222022002001012211
1111110111011111111011111101101111101111101111111100000011111022211212212222122012221112212020101222111111111011111110001110111112121121120212222222000212012211
1101111111001111011111111111101111110010111111110111111011011012022212120111122222121022012221121212221111111111110100111111011112022222202210221220110220021121
1110111101111010011110111011111110111111111001010000111111111012022001210222221022202210011102211112111100111110011111111100111011111102020110210111210110211121
1111111111011110111111111111101111011111111110110111111111010000111122112221122202222220222021212112211111111111110111111110111112120221101122020210021102222221
1110110101111111011111110111110111111111111101111111111111110212210101200221020022221121012022222212111110111011111010111111111111122121211202121110212211212220
0111111111110011111101111111111110111111111111110100011001011112102221111222120212211221202100202021201011001011111100101100111111211121101111111012012001220111
1111011011101111111011111010100111100110110001111011101111011200111222112210002102220220222122221101101111101111110111011001111101100201022211020222212221200111
0111111111111011101101101100101101100011011111011111111111001222121112102012121221212221202122121112210010011011110111011111111110222212112022022112012211012110
11111111111110011111001100001111111111111111101111111011111102212112110202bbbabbababbbbbbbbbbbabaabbaaaaaaaaaaaaaaaaaaaaaaaaaaaaabbbabbbbaabbbbaababbaabbba00211
01011111111110111110011101111101011111111111111111111011111112020220021221a2202222222221202012121221101110001111111111111111111100022201102210202010112010a11111
11000111111111111011011101011101011010111111110111011011001112111112201212a2012100210212221012102022020111111011100011111111001111212110021211101201022020a12201
11111010111111101111111110111111110111111111111011100111101011222212211221b2212202222102200022121111200111010110101111101111011111011111101001110111111110a11011
11111111111001011101111101110111111111011111111111011111111110121211012022a2201022202222122201101212120110111111011111111111111111110111110011110111111111a11110
11111111111111011011110110111101010110101011100111011110111010122220211220b2122202022022022211211221221101111011010111101100011100111111101111111111111101a01011
11111110111111110011111111111110111101001111111101011010111012122011212101b2210222221122222001200020221011011111111110001011111111111111100101011100111011a11110
11111111110111110011111101011101111111111100111111100111110111000111122012b0222222121112220012122021101110111110111111111111111111011111110111110011100111a11110
11010110110011001101100011111010111011111111111111111111111000120020122012b2121222022211222122222220111001110111111111111111100111111111111011111110011110a01110
01011111111011011101111111111111011110001111100011110111011012101122112222b2212222222222222222221111121110111110000111011111010111001111101001111111011111a11100
11111101111110111111011011111010111110001101101111100111110110102121100222b2222100221221021111221120121010101101111100111001101111011111100111100111001111a10111
11101111001111011101111101111111011110111111100110111111011110111011110122b2001022010222102202010112001010111101111110111111111111111111011011011110101111a11110
11111111011110101111011111111111111101110111010110111111101101111111111102b1011110021110220112011221111111100111111101101110111111111111111101110100110111a11100
11101111111101111101111111111101111111011111111011111110111111111111001121a2011022111102212210222222121111111111011011110111111111111111111110111011100111a11011
10111101110110111011011111011110111111110111101110101111110100111111101111a0220012202211201221000221121111111001110110010111111101011111111010101111111111a01111
01111011101110101111111111111011010111110111101111110010001111111110110021b2112122002021111000210121121111111111111111111110111111111111011110011011110111a01111
11001111111111111110110101111001011111111011111111111000111111111111111121b0102111100120211002221020110110110111111000110111111101110011111011111101100110a10101
11010111101111011111111010010111101111111111111011111011111001010110111102a1122212100021012121221212011011010101010110111101010111100001111110111111110001a11101
11101111111011011111111111111100111011111111111010110111111100111110011122a1112102211212212111112200221010101011111111111111111111111111111111011111111101a11011
11101101111101111111111111110011111110011101111110100111110101110111111101b1121211121121021210012220211011011110111101111100111101111111111111101100110110a11111
01111111110111111111111111110100101111111010111111111011011111011110111121a1120211121121212220202011220101001110100111111111100011111111100011101101011011a11111
