(153, 8)
(7, 112)
(158, 83)
(90, 111)
(103, 43)
(64, 88)
(106, 6)
(45, 101)
(0, 119)
(38, 53)
1111111011001011010111111111100110111110110111110111111010110011011100110111111001110111111101021121a10220002200220122122101111111111111111011111111110011101011
1111110001011001011111111111101111111111111101110110111110110111111111111011110111010111111212211022a20002221110211201121101111110010011001001110111000111011111
1111111111111111101111111101111111110111101000110001001111001011111111011111111001101101010122222202a10211112121111111110111011111111010111111110111010111111101
0111111111111111111111111011101111111011101101111111111111111111110110110010101011111111111212222201a21011210211120221121111110110101100110010100111101111001110
0111111110111111111110111111101110111111111111111011100011011111111101111111111100111011111100211112b21102221001121210110111111101110111111aaaaaaaaaaaaaaaaaaaaa
1111111111011111111101111111101111011101101111101111100010111100111111111111111111001111111221101121a22212221001120021201110101101111011111a11110111011110111011
1011111010111111111111110111111111111011110111111111110011101111100100101111111111111111101120212111b02121222121121220111111111011011100110a10101111110011010111
1111110111001110111101110011111101111111011111111110111111111100101101011001111111111111111122100110b22022222122011022122111111111011111111a10111111101101111111
0010111111111111111001110110111110101111111111011111101011111101011101110111011101010111111101121221a01222221100211121222011111011111111101a11011111110111001111
1011111100111111111111011111111111111110100110111111111010110101011111100100100001111111111212211011b02212211111122121221101001111010010101a11011111111111011111
1011111101100110111110101100111111111110111011011111111101110111100011111111101101111111111112221222a22122220101220222212101111011011101001a11111101111111111111
0111110011101111001111111011111110011010100000110101111111101111110111111111111111111111010211202222b00202001211122220222111111111111010101a10111111110111111111
1111101111111111111110111111111101001011001111111111001111110111110110111111011011111111100200111002a01021112222112110010110110111110111111a11111111100111001110
0111011111111011001001111111111111111110011011111111111111101111010111111011101111110110111112110211b11002212221210202010110011111101101101a10011011101101110001
1111110011010111101110111111100011111110011110011111011111001001011111101111011111111111111012020222b22222221022222222222111111110110100111a11011111111111101111
1101111111111011111111111011111110111101111011111111011011111111111011111111011010101111111112120002b10221111012022222011111011100110011111a10111111111101110111
1111111101101111111011000011011101011111111110111001111111101100111111100111111111111100011210120002a11112122201101222021111110111100110111a10011011110011111011
1111111111110111111111111110101111010100110110111111111111110111101111111011111111111110111201010212b21221102112202202022111110000110111110a10111011010100100111
1111111101111111110101111111101110011100110111101011111111111101111111111111111111001110110120202111b22002110221111112121110111110111110111a11111101111111100101
1111101011110111110111101111011011101110110110111111111111010011101111111111111011101111101011220200b21010111220011210200111101110111111110a11011100111111101011
1001001101111010110111111110110011111110010011010011010010101110111101111110100011111011110222221121a22200121202100222211111011111101011101a10111111111111101101
0111111110110101011111111111111110111111000101001001100111101111111111110110101110110101101110111111a11111101111111111111001011011111111111a10111111111110101111
1111111111111101101111010110100110101111111111000011111110110111011111111111111111111111111011110110a11111101111111101111111111111111110101a10010111111111111111
0111001111111111111101100100111001011110111011101011111111111111111111111111001110111111111101110111a11110001111111101100111111111110001011a11110111101000010110
1110101111011110111101111011100111111111111101111110110110111010111111111111110110111111111111101011a11111011111110111111111111010101111011a11111010111111111110
1110111101011110101011111001111110110101001110111111110111111110111111111111111111111111111111001011a11111111110111011111110110111110010101a10111111111011001111
0111010101110000011011111111101110111110111110001111111111010111011011111111011101111010110111111111a11111010111111000111100111101111101111a10111101111111111111
0111111111111100111111111111011101011111101101101101011110111001100111111111010011111001100101010111a11101111111111111100110110011111100110a10011011011111111110
1111111110111111111110111111111111111101101111101110101111101101000101111111111111111101111222101112b20101201121011211110011111100011011010a01111100011111110111
1000111101111111111111010111101101110111101111111111111011011111111111111011101111111010001100002221a02110022002202112111111101011101110111a11111111110111011110
1011101101010111111101111010111110001101101011110101101100111001111101111111111111111111121010222212b11222012112122122111010110011100100111a11111111101111101111
1011101100111111100101101111100011100011111110001110110011111011111111101011111101111011011201210111a22210211011121120111010110111101110011a11111101111111111111
0011110101011101111111101111011111111110111110011111111010111111011111111011110101100110120212212222b10022202211021221111011101111101111111a11101111111111011111
1111111011111111111111011111111110001111111111101110111111011100110010111111011101111011021101211101a20111111121120111001111011100101111111a11101111110011111111
0111010111100001011011111011110111101101111101111111001111101111011110110011111111111111212222210210a21122211111121211111010110011111111110a11101111011101111110
0110111111010111111110011101111110011011001010111111101111111110011111111010111111011111001222202212b10011222101122121111110111111101111010a01001110011111111111
1111011001111101101001111111111111111011111101111110111111111101111101111111010100110011110021221011b22012021110102002101111111001111111111a10111111100111111111
1111101011110110100111111111111111011011110111011111000100111011011111111111011111111101010201122021b02110210011202202111010111111101011111a00011011110111001110
1111011011111111111110000000122211111101222111220212111111101111111111110110111110011101211122112112a11010110201122011011101111111111111111a11101110111111111111
1000111011111111111111121011222211010212211202210112100110111111011101111001110101111000002001111210a21111211012100211111110011111110111111a11111111111111111111
aaaaaaaaaaaaaaaaaaaaaaabaaaaaabbbaaababbabaaabababbbbaaaaaaaaaaaaaaaaaaaaaaaaaaaaaaaaaaabbbbaabaaaaab01021001101022020001111101110111011101a01010111101111111111
1111111011011111011111112020000112112111110222212102211100111101111101111011100111111111101220110112110002011221210111101101101111111111111a01111101111101101111
1101111101110111111111122021112212022221112121122122011001100001111111011000011111101111101111212222011100221102121221101111111110101111110a11111100111011110010
1111111011111111111111122111222120101121212110002221210111110111111110011111111111110111022210121112210002021222021100110111111111011111111a11111101111011110011
1110111111011011110110122211212201120210111220200202201111111011110101111101101111111101020221101221022120222222000121111111110111111110111a11001000111110101111
1111111111111111110110121102222220212112211122112220211111100110111101111101111110111111001022212212220212100112112011110111000100110111110a11011111111110110111
1111011111111110100101121120222022210221112121222201111111111111111011111111111111010011101101102111110211200212120120111011111111111101110a10111111101111110101
0111011111111111101111122122010112221002121121211212011011101011100111110101111011111110201221221222222200221122022021111111101110011111110a11011111111010111011
1111111101101111001101001122201101111200012001211222011111001101111011111110110110111011120112122221222102221222200201111110111101011111111a11111111101110110011
1101111101111110101111121112020122102222111120110011211111111111010011011111100111111111102122221011011221110011122100111111111101111011111a11111011101100111111
1111111111111111011111101002201102111221102011021201111101011111111111110111110110110101011201222122211111102212111020011111111110111111111a11001110111111101111
1111100111111110110111100202110020201222111111000012111110111111111011111001111110101111112002112222022211121102111212111101111111110111011a10111111111011101111
1100110111111110111111112212102022221121002021212102210110111111101111111011111111111011112022211222221222011001222121111010111110111010111a11111111111111101111
1111111111101010111101111122122011222011121111002011111110111110011111111111111110111111011200222202222222221022121221111111111101111011111a11110111110111111101
1101111101111110011111110122111122220202112212222012201110110111111011101111111001101111120101111212022102212102102001011100111111110011111a11111111111111111011
1010111111101011111111101212210222111201221222110002010111110011111101101111111111111111111202110222201011011202002212110111011001111011111a11001111111111111011
0111111101111011010111012221100011112001221111121211211111111110110111101001111111110000121222122212220121221122222120111111110001111111110a11011111111011101110
1111111101110010111010112220112021010211122022011112111010001111100111011101010111100110211111222011212011200111112212001001111100011111101a11111110111100111101
1110011111111111111111102211220011010022012211100111210100111001111111011111111111011111111111100011110011001111110110010111111111111111111a11111001011111111111
1111111011111011111111122101222211222102122221121122011111111011111111101111111111000110111110011111110101110111111111111111111111001111111a11111111010111111111
1101101110110001011011112222202220112021212111221011011111111111111111111001111011010111111101111111111011100111110100101101101110000111111a11111111011111111111
1111111110110011111110102221221212212121112202121111011111001111110111000111111111111100101111101111111011111110111011111111011111101101000a11111101111010110011
1111111111111011110010010122011211222201212102112110111011111111111111111101111100111101001111001111101001001101110111111011110111111111111a11011110101111011111
1111111110011011111111001212021201210021001211121120111111011010011111111110111001101000111110111111110000001111111111011111011101101110011a10111101111001000110
1101111111100101111111112120020222021111020210022202111111111111111111111110111100111111110110011111111101101011111110101010111011111110101aaaaaaaaaaaaaaaaaaaaa
0011111101111110101011112101121012002221101122011121211101101110111111110110111111111011111111111101111011001111001111101000101001111111111111101110101111110111
0001111101111011011111021212112121121021021101211020201111001100111111111011111111110111010110110111100111110111111111011100101111110111110111011111111111111100
1111111111111001101111110022212010022112102221111220111111111001111101111111001111111111111101110011111001101011110111111111110101111011011011110111111110111111
1010111110101111001111000111111101111111111111101011111111010101111111111111111010110101111101111101111111111100010011111111011111011111011111112111201101110202
1101110001101101111111111111011111010100111111111111111111110111111110111111011101111111110110111111010101001001111111100110101010111101111111120022121112111112
0111111010111011100111101110111111010110111011111110011011110111011111110011111110111111101011111100111111110101111111111111111111111111110111112222121101202010
1110111111101111110011111110111111011101111011110110110111100011110010101111101011111111111111111011111111101111111111011011111001111111001111110121221001120022
1111101011111111011111111101111111011101111111111110110011111111010011111101101110011111100101000111111111101111010110111111001110111110111111102122110002221102
0010101111011111111111111101011111111011111101111121122022210101110022021212202111111110111010111111111111010111011010101111000111100111001011022001022110200210
1110111101111011101101111110111111111111001111101120212021222212212220112120201110011101111111111111011110110100111110111111111111110110011110101122001112121012
1111100110011011101111111101101101110001101111111221210021120220022122011011202110011111111111101110111110111111010111011111110111110111111101110110211221211012
1111111111001001111101110111010111111101011111010221222111022011212212202222120111110111111111011110111111101111111011111101110000110111111010111111210120111202
aaaaaaaaaaaaaaaaaaaaaaaaaaaaaaaaaaaaaaaaaaaaaaaaabbbbbbbaaababaaabbbabaabbabaaaaaaaaaaaaaaaaaaaaaaaaaaaaaaaaaaaaaaaaaaaaaaaaaaaaaaaaaaaaaaaaaaabaabbbaaabbaababa
1111011011111011011011111101111011011101110110110212022121112011222111011210222110001111011111110011111101010111001111110111111111001111011111122112212122101112
1011011111101101011111011001111111111011111111111120201112022202110112111121010110111111110aaaaaaaaaaaaaaaaaaaaaaaaaaaaaaaaaaaaaaaaa1111001001101212222220020111
1101110111111101110111111101111101001111111110111102211212110111101022001221201111111101010a111110111011101011011010110111111111110a1011011011121012202111112210
1111111111111001111111011111111111101110111110101201110122020020122112110022221111111111111a111111111111101110111111111110111111101a0111110111002222112212222100
1111111101111110111110101110001110111011101101011100211000011122100200121222222111111111011a010110111101011111111111111110111111111a1111111111110221122012120122
0001101111111110111111111111101011101100011111001202122220121100121121221121000110100011111a111111101111111011111111110010011111111a0111101011111111212121201222
1101101111111111011011110110111101011111111111110021201012021211201000112122112111111100100a011111111111111111101101111110111011011a1111011111001220112010110100
0101001111111100011111111000101111101001111101111210110210020012111122101212122111010010010a101101111001111010011110100100111111111a1111011111102102122201011222
1110110101111111010111110111111021002211212121011222120010211122202112221221011111111111111a001011010101111111111111111111101111111a0111001111122212121122220121
0011011111111101111110110001100211212211122011202022112222220122111011001012120111111011110a011011111111100111111100011011111111110a1111111011101200110212222201
1110101101111011101011111111100021212211011211111220000200011001120111102121112111111101111a110110110111011011101101111011001100100a0110111110120211221222121022
1111111011111101111011111111110022010221220121112221120212121221112212022221002111110111110a011000110111111101111111111110110110111a0001111101102002111011022220
1101101111011111111111110111112110110102121021112010020201112021221121211220012111111011010a110011111111110111111111111111011110111a1111111110011112021011222011
1110111110111111111111111100110200210101211121112201122212220121221012021210101110111111101a011000010110111111110111110010101111111a1011101101012222201111111012
1111011010111011001111011111112101211201201200222200012202210211022111110210121111110111111a111010111111101111011110111111111111011a1110111111112212020202111210
1111111011100101010011100101011011121121212110011122222002222102220020111211001101110010101a111111011111011101101111111011010100111a1111111100102211220121202111
0111011110110101011110011111111120022011221201212212121222222101122122102121120111111100111a111111111010111111111110110111011110111a1101111011111202012101010022
1111011011111111111010100111011121122002220112211222121201201222212220022220220011110111111a111011001111111111100111111111111110111a1111111111112221221111220112
0111100111001011011111111111112111222022111012210222212200222102121111122212212222012222112a111211101220110111111011111111011110110a1111111010121211111111020122
1111101010110110111111111111111020122222122022202222202022102121111221021220121111222110101a212101220110211110111010101101111101110a1111111011122221222112200011
1111001111111001011111011110101222202111222210122221000121101200222121112121022111100121112a101112211022111101101111001110111110111a0111111101111111111111111111
1111101110111110111111111100112222012201111112220021210220121121202102222212122212011102121b120011220120210110111111101010001111110a1111111111001011110111101101
1111110011111011110110101111111221111222220221120012220202202122202101112111222112121212210b211001101201111110101111101111111111111a0111111111010011111011111111
0111111011111111111111110111112122221202211022121212220220022201222212221222221222110202221a110122011021211100001111111100100111111a0011110101111111000111011110
0111010011111111001111110111112012122122222102202001110020201212202201211211222122111202202b102212022121111111001111011101111110111a1110101110110011111101111111
0111011111010101101111111111112112111011112202111101120021011110110110111011120221220111200a222121211012211111111101111100101101111a1111111100110111111110000111
0121121111111211111111111111111111201211112202021120122121221111111111101111212120110102221b220112111221210111010110111110111111011a1111111111101011111111110111
0010112110000201111111111111012221001111100212101020222012011011111110111011210001220211011b111010212222211011111111111011100111001a1111101011110101101110011111
1101101112222121111011110110111112122211212201022100212222100110110111111011020200012211211b201122111102211111010011110101110101101a0111111110111001101101010011
1011211202220200111011101111112021011222122122021012211122021101011011110112212001212111112a122212022111111111111110111111110001101a1101110110111111111111010111
2011120011112210000111111111110111122120112212210101222010111100111111001112212112210102201b210012211201210001111000001111110110101a1111111111101111011111011111
2122011012012211001111111111112101120112112011122211211110121111111110110111202021111220212b211202021101200100111101111011111111111a1111110111111111011101111111
0220022102011100101011110110112222111021002102202021202220210111100111111111002110111010201a110121212222111111001011111101101111011a1100011011001111111111100111
0211212100011121110111101111110211011012211102021111122021211111101110111110121111212022210b011120102120001111011000000101110101011a1110011111111100110111111101
1110111112121021101101111110101122222211202021001221121222211111111110111112002121101120112a201020211210200011100111101111111001111a1111111110000111111011111111
1211201221101111011101001110111121002021222021110211112120211011111110110110211101122121120b101102020211011111110111111010111101111a1110101111111111100110101111
2021112211210221011001111110101202001122121211101201021222021011101101111011201111210222210b220211121121001111111010111111111011110a1011010111010101111111100111
0022020011021111111000111111112221021200221212122122212121111011111111101110212221111101221b011211112112111011111101110111111111011a1111111011111111110111110110
2121112110202211111110110111011011101111101110110111011011011111110010011112111112212212021a111221002122211010110111111011101101110a0111101111111110111011111101
1201201122222211111011110111110101111111111111111101111111011111111101111110202112210122220b220022020222210111110111111011111011111a1110100011111101111111110111
2222202002210210010010111101111101110010111111111001111101111111110111100111120011212010100b012221112221101100111111011011111001011a0111111111111110111111110111
2210202022222001001111011111110111011110111110011110111111111111111011101111110001120111212b121101012002100111111111111111111111111a1111000101111110110111010101
