(150, 119)
(17, 115)
(37, 93)
(93, 78)
(88, 20)
(19, 27)
(145, 60)
(74, 17)
(66, 75)
(129, 22)
1011100101011111111110111011101011111111a1100101111011111011010001110101a101110101111111011100100111111110110101111011011110001101111110111110110111011111110010
1001011111111111101110011101110111111111a1110100111101111110101101011111a111111011100110111100001111011111011111101111010111101110110111101010111110111111101101
1111001011111101100111111111010111111111a1011001011011100112120112202222a121100022221211210111110110011111111001010111111111001011111111111111110111010011011111
0111111011100011011111111010110011101111a1111110110110111110112010120211b020101202121211201011010110011101011111111100011111111111111110011111111010111101111001
1111011111111110111010111111101110011101a1101110101111011112201212012221a121101002102022010111101110111111111110111110111110110111101111111111010010111001111101
0111001111101111011110100111011011111111a0111111111101011111112202001122b022222222212222210221010220212110010011110101110101111111111101101111011011111101111111
1011101011111100111011111011011111111111a1011111110110011111000220210221b0222222212202222102000111112211111101110010111aaaaaaaaaaaaaaaaaaaaaaaaaaaaaaaaaaaaaaaaa
1111111101111111111100111111111101011011a1111011111111110110222120121021a2221022222022200110221202212121101111111112221a0112222120101222200120101110101111011100
0111110011101101010111011111001111101110a1111111111111010112102122211121b2202202222222221101021212121221111111011122112a1202121211100021002120111111110111111111
0101111111110101101111110111111111011111a1111111011111101111101111021220b0020222022122212221121000101211111111111101200a2112212221111012121112210110111000111111
1110111111100111101101111110110111110111a1000111111111101110120210111212a2102222220220022002221120101210111100111110012b1221011221211022002022101111111101101111
1111111011110111011101101111110101111111a1111111111111111010122101112121b1102002112022221202000011220021101100011011220b2211211102002002111010210101011100101010
1111121112221202012021102020022201111001a1111111110111000100100012111212b1222101201002220112120221111210111011101120112a0100111111222020221121210101011111101011
1111011101212112102100111222210212111010a1111111110110001112212122222021a1222102111222221210110120211121001111011112001b2112211122122002122110221111111110111110
0101221201122212121211011210010102111111a1010111111110011112011220012212b0120222212222000121112012121210111111111111210a0212111202222101222210010110111111101111
1101021022021211211221202120002011110111a1110111111111101011202122210111a2222102002121122201210121222121111101110121122a2122101222211122120222211111111110101011
1111102002112222121111202121022212011011a1000110110011101012022221120212a2200022202200222112211221020211011111111101011a0121122112102011120211101111111101111101
1111012102022022011221221021200110001111a1101011011111111110110212222221b2212210021020122212212212010021101000111121112a2101122100202202220212101010101011111101
1111122021121120222101222212101211111010a0111111011111111110121002022201b0211120222222202022011112122120110101111120122b2120220202122001211021020101111011111110
1101112011112110122222221201101210010011a1101100111111111110111211022221abbabbabbbbbbbaabaaaaababaaabaaaaaaaaaaaa101222a1102210220122111120110220110111111110111
0111122020002222212122101221122211100010a01101111101110011022020211121102022202102001112021222202001200001111111a122110b1011211121001212122121020101001110111111
1111212211201211220222011122222111111101a11110111011011101121111010211121122012222112222212111201112201100101110a122111b0020120012021100102112011011111111111111
0011001120200012122012110202120022111111aaaaaaaaaaaaaaaaaaaba211212122210101212222200211011022022221202001010011a122200b2112111112212202220102221101111111111101
011122012022101020112121112222212011111111111111111111111112b122212212011222122112200220210121120102101111011101a002210b0210101212001101011210021111111011101111
111111201100111001112211202210112001111101110110110100111112a221012022110122222201212102211100021221020110011110a100011b1120011202102222121122101011110111100111
111101120100221111012221021212212011111111111111101101110110b220121110112001120220120122120221220121220111110110a010122a0201202212202200200200001110110111110010
111112012212021122111112011011221210111111110110111111111111b012022211120102022220122222022221001121010111011111a121000b1112012102221122100122120110111111110011
111111020222222211122120122220211111110101010111111111111112b212122121000212010002222120222012110202002001111111a112102a2011221212111211210021121101101010111111
111101012201212022212200210221111111101111111001111111111101b101121021120022022022111222221222111000111011101111a122111a2202022212202221200101121011111110111111
111110111021022222101021121221122001111111100111110111111100a201121011002122222200211210122100122211110111110111a012011b1222011120212011111120101111111111111001
111110021211111201220121211211122110011111111111111111110110b102011122211120202121020220022122210112022111011111a021221a0210220010200101121112111010110111111110
111111121112201021221111112101222011011111011111000111111112b001120121201021002222222222021221111221121111111110a122010a2111000220012122110111211101011111011111
111011221011022121012220200120011111111111111111111100011011a111111110010121212221120200212221010112222101111111a112211b1101012111200102012002111111110111110010
010121212220222011112000021111121201111111111011111100101111a110111111111021121220221211112122121212222010010111a011122a1221102100112011102210120111111111110110
111012011221122211121101222012120211110001111111111110111111a101111110101112221212022111102211001112220011110101a111222b1101122111111010101222010110111110010011
000101110112112012210211221211221010111111110111011111111111a111111100011111101111110110111111111101111111111110a111121a2002122121111221211202011011111110111110
111122011121220210002121222122001101011011111111111001100111a111111111111010111111111111111111001010111011110111a121210b0202012222211221210220211001110111101111
111111011111212211202101221221122111111111011111111010011111a111111111101001111110011111111101111111111101111111a111101a1111101001101111011110111111010111111010
110121112110122222120122122121012210111010110011011111111111a111111111111111001111101111111101111110111111010101a111100a1110111111111010110111110011110011111111
111111221120102221110122112100111111101011111000001110111111a011110111101111011001011001010001111111101111111110a111101a1111011101101111111111011101110011101011
111110112210111010010200212111220211110110111111111111111111a111111111110110011110011111111101110111111111111111a101010a1111010011100010101111111110111111011101
111111202012201211001202222102021211101001101100111101111011a111001110111111111111101001111111101011011111011111a111011a1111111111111110101011011010011001010011
aaaaaaaaaaaaaaaaaaaaaaaaaaaaaaaaaaaaaaaaaaaaaaaaaaaaaaaaaaaaa100111111111101111110111011011011111011011111110111a010111a1111011001011101101110110111110110111111
1111011111111110111111111111011111101011111101110111111000111111011110101100111011011111010110111111111111111111a111101a1111101111111001011101101001111111111111
1111101111101111011110111110100011011001111111101011101111101111111011111111111011001011100101101111001110111011a110111a1011011011111110011100110100011110111111
1111111111111111110110011110111111101111000111111111111111111100011101111111110110010101110110011111111110111111a011111a0111111100021210122221010102012012021202
1110010110111111101111111110111101010110111011010011111111111110111101110111101111111111111101101011001011111111a011110a1011111111222221221ababbbbbaabbbbabbabba
1111101111110111111111011101101111111111111111100110101010111010110111110111011111111010000010001111110111111101a111101a1111011111000221002b21002212221121122121
1111110111111110111011101101111000111011101101111111110111011111100101111101111001110011111011100111111111111101a111111a1111111111111112122a21221221121121102022
1011111111011111111011111111101111110111111111101110111111011111111111111111111110110111111111111111111111110111a110111a1111110111222011021a20111120121212201012
1111111111111111011100101111110111010010111111111011111111110111111100111111011011111111111111111100110111111101a011011a1111101111112112211a12111112122211112001
1111111010111111001101111111111111011011101011111101111110110001011111111010111111011101111101110111111111111011a011011a1101011110012211212b22011200101122111121
1011110111011011000111101111111111111111001111001111111111100111111101111111111010111111111111111111111111111101a111111a0111111011211202020b02210111210200222101
1111110111101110111110111111100111111111011101011011111110111111010101111110110011111001111101101011101001111111a111011a1001111010021221112b12120012011000111022
0111110111100111110111111111111111101000111111011100111101111111111011111110111110101111111111101111111111111111a111111a1111111110221221221b12210100122212211222
1110110111011101011001111101011111111101011111111011111110111011111111111110111111000111110101010111111111011010a111111a1011100111111212021b01211221112022121221
1111101111111100111111010011111111110110111101011101111101101111011001111111100111011111110111111111100011111111a101111a1101111111020021021a02020200121211211112
1110101110101101011101010011111111011100111110111111111110111011001101011111111001111111111101101011111100111001a011111a1111110101201022212a12201000020222211122
aaaaaaaaaaaaaaaaaaaaaaaaaaaaaaaaaaaaaaaaaaaaaaaaaaaaaaaaaaaaaaaaaaaaaaaaaaaaaaaaa1111101111111111111111111101111a001111a1111010111122112222b21222022202021111012
10110011111011111111111111111111111011111111111011111011111111111001111100111001a0011101011011111101111111101011a011111a1111111111011222021a12120212201022221021
11111111010111001011101111110101111110111101011111110221120200122022222202002002a1111101111111110111110111110101a011101a1100011101222112102b21020101121121201020
11011100101111111111001101011111111100010101101001121121210212021122222210121111b1101110101111011011111111011011a101110a1111111101221200201a00010222122202201011
11101111110111111011111111110101011110101110111101122022222101211201202001221221b0111111100111001100111111111100a110100a1010111111022102120b22202212211112112221
11111110111111011111111111111110111011111011111111110211212121221022221112202102a1211211222022021012212111121111a111011a1011110011220220122b10021010210201222020
10110110100101101011011110010110010011011011111111011211122020221122011211112122a1221211001121211021201121021101a111011a0110100111001201111b20121101111021211220
01111101101101010111001011111111111111111111111100111012010120110212120211011221a0201110101112100222200000210011a111011a1111001111212022202b12102100202202102222
11111111011110111110110111110011110111111110111001111021111210221011122002122121a1221101101110112121122121020111a011101a1110111110022211102a21222122211110211002
11111111111111111011111110101101111101111110111111121121111222120220111212110021a1221112212121120101110001211111a101111a0111111110220020122a22101211012111211122
11111101110111111001110111011111110100111110101001112010102210111202112011012122b1210102222011122210021021220111a110111a1111011111212121021b02122022111221122201
10111010101111110101111011111001111111111111111111102221012210120211102112022222b2111212121212100101212102120111a111101a1110111111122021012a12112212201212112221
11111100111110110111111111111111101111011111010111102212122221121121222222101211b2022212222010111221012121121011a110111a1110111101102222101a02220112222112101202
10111111110110011110100111011111110111111111111101111011122212021212121201101022a2112112212221012110012020010000a111111a1111110111221001112a20102012112212012121
01101111111110001111110111111011111111011111111010011211221111120112011221212222b0112220212121222012001010101111a110011a0000100111011222010b22121222001002220112
11101110111110111001011111111111111011111101111111101220102122210212211212011020b1122102122022211001012121011111a101111a1011110111221210011b01112122210022101110
01101011111111110101100111001111101110011101111110011111222212021122111120100210a2202211111121212011122120010111a111101a1101110101220222100a10011212022112111111
01111111011111101111111011110011100110111111111111102212211121222221101212202220b2000111111211120112102222021011a111111a1110111111111111101a11111111011110011101
01111111010110101100111100011011111111111100111111122022110101112121121112121212b2221222102221110222202210121111a101011a1110111111111110111a11011111111101011011
11110011011111101001111111010111001011110111011111111021110101111110020212212122b2002012221110011212102012100011a111110a1011000101101011111a11011101111101101111
11001111111111111111102210221102201011212110121112021201001110211010002111012012a0122200201022122111111210021110a111011a1111101111110010111a11001001111101100111
11111111111011001111011221112210002110121121112000221010221211021220120010220201b2101120201011212100122120120110a110111a1011011010110111011a10101111001111001110
11111111011111111101011122021112221002021101201122020122110121121222102121222122b0110121021211002212101011101011a101101a0111111110111001111a11111111111111111110
10111101111111110110111202111111201222112222021120022212221220120021021211201121b2121222112120101101212021011111a110011a0111111111011111110a01110110101111011110
11111110110010111110111212211011121111212201112120120111222202122000211021121111a2121101211121121212121211220111a111111a1111111101111110001a10111011111111011011
10110001111111110101112122200110022222101111111110222211122011121211011111211121a1122101212122022012211121011110a010111a1111111101010111111a11110111110111011101
11111101101111111110101222122120122012020112222221121121220222222201120011222122b2210221112112121202020202101111a011111a1101010111111111101a11111111110111101001
11111101111101111001112112211101011201222011210212120212220102110222111012101121a2120201111122222210120120220000a111111a1111111111101111111a11011111011010111100
11111111101101111111111210001221121211112111221202021022221221202020122111111112a2222010121212000222222002101111a011111a1111100010111011110a11110110111111111111
11111111001111000111011211022110221122120111221211212202110110120211202202211012b1222012022221122022110111021110a101111a1011111111111111111a11101011111110111111
10110011110111110011111222111110211122111201010222221212211120021112012120112022b2220201222200111112122000221111a111111a1101110111101111110a10111111011011011111
11111111111101101011111012101021222100010100222012221212022212122012210101120110b1100202112022022112112210121000a110110a0111111111111110111a11110101011001011011
10111001111110101111110222121122212222022121221210220010101110101111111111110021b0021222121200221211221210221111a111111a1111011111011111111a01111111111111101101
11111011111111001111111211101221102122221101222221221111111101111111101101011022a2000211212100211120100012201101a111011a1111111011011111101a11110001111111101100
10111101111111011011110011102222211210100110221122121111111101111111111111110122a0021210201201222011210221201110a110111a1011111010001011111a11110011111010111111
01111011111100111101112021112112111201211112221102120111110111001111111011111111a1011011000110111101111011111111a011011a1110111111011111111a11011111111101011110
11111111100000011110100222112222102111120212210000121111111101111010110111111111a1111111111011111111110111001010a101101a1111110111100011111a00111001011100111101
11111011011010110111112120220211102222100210211120111000010011111101111111111111a1111110111011111100110100001110a101100a1010111101110101111a11110011010111111101
10110110010110111010112212120121102011211122120202211111101010111111001111101010a1001100111111111101111111111110a111111a1111111110001001111a11101111001011100111
01110111101000011111112210211201221111210220220021021101110111111111111111100110a1110001110111111011111011100011a111111a1000111001000110111a01111011100111111011
11111110111111111110111001021111212122122012220121211111010111101110111111111111a1011111011111101111111011011111a111000a1111011111111100111a11111111011111111111
01111011111110111111111002201201102221111110011022211011111100110111111101111110a1110101111011111111111111111111a111111a1110111101111111110a00110111111111111011
11111011111111111111111200201220000201121002022102201111110110111111111110100111a1011111101101111111101101111110a111101a1101111111101101111a11011001100111111010
11111111111111010011010011122222121022220200220121221011111011111010110111111011a1010111111111111010010101011011a111111a1111011101001111111a11111011111111001111
11111101011101110111101022221212122011222112111212011011111111001111100110011111a0111101111001111101111111111111a111111a1001001101010110110a11111111111101110101
11001111010111111101111210212100102201120020102120211111111111111111111111011111a1111111110111001101101111011111a111111a1110111100111111111a11101111111111111101
11111110011111111111112012201110010222202111121011221111111111111111111110101111a1010101111111111011011111111101a100111a1111110111010010110a10111101101110111100
11111100011010110101011122021220222122120112212122210110111101001111101011111111a1111001011110111111111111111011a111110a1111101111111101110a11111100111111111111
11111111111111011010112222112100112220120011011220211110011010001111100111111111a1111111111101100110111111011011a110111aaaaaaaaaaaaaaaaaaaaa11111011111101111111
11110110101111011111102201202101212020110101021002121111111011101011110111101001a1111111111111111111111100101101a11110111010001011111111011111111110111111100011
11011110111111111101111101011111101111111111111001011101101101110111111110101011a1011110001011001111101111111111a11111101011111111110110111010111111111111101111
01110100111101111111110110111111111111111011111111111011111110111111111111110110a1111111110111111101110001111110a01111101001101111101101111011001111011111111111
11110111010111010111011110111111011111011101111010111111101111101010111111101011a1111111111011101011111100111111a10110100011011100111111111110111011011110100111
11111111110010011101111110111111010111010101111000111111111111101111111110110110a1001110101101111111111110001001a11111011111111111011111011111111100111101111010
11111110111111111001110101101111111101111101110011111111110111011101111111011111a1101111111111111101111101111101a11101111101101100111111111001111101011111011111
01011101111111101111111110101011011101001111111101111111110111111111101111111011a1111111111101101010100101011101a11111110101111111100110010111111011101100101101
10111110011101111111011111111111111111011111110111110010010111110111000111111111a1011111111011111111101011011111a11111100110010111101011111111011111111111111011
10101111010110101111111010101011101111111111001111111111110111111111111101111111a1110111111001111111101011111111a11110110111101111111111111101100101111111101111
11110110011111111101111111111010111111110001011111001111011110110001011110110111a0111010111111110011111111111011a11111101111101110111111111111011111000000111111
11111011111101111000110101010011111110111101010101011111110111110111111111111111a1001101011111111101100111101011a11111101111101111111011111110111101111010110011
11111111111011110111101111111110110111110110011101111101111011011110111111111101a1110111111111011011101110111111a11111110110111011110111101101110011101111011111
10111111111101111110111011111101011111110110101010111111101110111111111011111111a1001001011111111111111111111111a11011101111111110111100011111101111011111000111
